一乾二淨=一乾二净
一乾人=一乾人
中乾=中乾
中文卡=汉卡
中文拼音=汉语拼音
中斷點=断点
中斷點續傳=断点续传
串列=串行
乾先=乾先
乾兒=乾儿
乾凈=乾净
乾大=乾大
乾太=乾太
乾女=乾女
乾娘=乾娘
乾媽=乾妈
乾性=乾性
乾果=乾果
乾沒=乾没
乾淨=乾净
乾濕=乾湿
乾爹=乾爹
乾老=乾老
乾草=乾草
乾親=乾亲
乾餅=乾饼
二極體=二极管
二進位=二进制
互動式=交互式
人工智慧=人工智能
介面=界面
介面卡=适配卡
仲介=中介
仲介方=中介方
伺服器=服务器
作業系統=操作系统
倒楣=倒霉
倖臣=倖臣
倡狂=猖狂
假像=假象
傢俬=家私
催乾=催乾
傷癒=伤癒
像是=象是
像樣=象样
像樣兒=象样儿
光碟=光盘
光碟機=光驱
全形=全角
共用=共享
其他=其它
列印=打印
功能表=菜单
加舖=加舖
包乾=包乾
匠舖=匠舖
十六進位=十六进制
十進位=十进制
印表機=打印机
口乾=口乾
可攜性=可移植性
史達林=斯大林
向量=矢量
吹乾=吹乾
咸豊=咸台
嚕囌=噜囌
囉唆=罗唆
囉嗦=罗嗦
囉嘍=罗喽
國際奧會=国际奥委会
圖像=图象
塑膠=塑料
增強塑膠=增强塑料
壁報=墙报
大型積體電路=大规模集成电路
奔相走告=奔走相告
套裝程式=程序包
套裝軟體=软件包
奧會=奥委会
宏都拉斯=洪都拉斯
官慾=官慾
對話方塊=对话框
尺規=标尺
尾碼=后缀
崑崙=崑仑
崑曲=崑曲
布希=布什
床舖=床舖
店舖=店舖
康得=康德
康橋=剑桥
影印機=复印机
彷彿=彷佛
徬徨=彷徨
性慾=性慾
悽其=悽其
悽切=悽切
悽婉=悽婉
悽怨=悽怨
悽悄=悽悄
悽惘=悽惘
悽惻=悽恻
悽愴=悽怆
悽慘=悽惨
悽清=悽清
悽然=悽然
悽頓=悽顿
情慾=情慾
想像=想象
感測器=传感器
慾念=慾念
慾望=慾望
慾火=慾火
憑藉=凭借
戈巴契夫=戈尔巴乔夫
打矇=打矇
打草穀=打草穀
括弧=括号
捍麵=扞面
捲軸=滚动条
掃描器=扫描仪
排版=照排
揹債=揹债
揹包=揹包
揹書包=揹书包
揹榜=揹榜
揹縴=揹纤
揹行李=揹行李
揹黑鍋=揹黑锅
搽乾=搽乾
摺子=摺子
摺紙=摺纸
撘舖=搭舖
擦乾=擦乾
擴展匯流排界面=扩展总线接口
攜帶型=便携式
數位=数字
數據機=调制解调器
新紮=新紮
明瞭=明了
晶片=芯片
智慧=智能
暫態=瞬时
書獃子=书獃子
枕蓆=枕蓆
核反應爐=核反应堆
核子試驗=核试验
條碼=条形码
模組=模块
毫安培=毫安
水準=水平
沙烏地阿拉伯=沙特阿拉伯
法定程式=法定程序
法律諮詢=法律咨询
浮水印=水印
涼蓆=凉蓆
游標=光标
滑鼠=鼠标器
演算法=算法
灣蓆=湾蓆
炕蓆=炕蓆
燒燬=烧锻
片語=词组
王碼中文卡=王码汉卡
甘迺=甘遒
畢氏定理=勾股定理
番茄=西红柿
病癒=病癒
痊癒=痊癒
登出=注销
皮蓆=皮蓆
相容=兼容
瞎矇=瞎矇
瞭如指掌=了如指掌
矇住=矇住
矇唄=矇呗
矇混=矇混
矇矓=矇胧
矇騙=矇骗
矽谷=矽谷
硬體=硬件
磁區=扇区
磁片=磁盘
磁軌=磁道
票據列印=票据打印
福馬林=福尔马林
程式=程序
程式控制=程序控制
穀倉=穀仓
穀草=穀草
穀雨=穀雨
穀類=穀类
積體電路=集成电路
穿梭機=航天飞机
竹蓆=竹蓆
管理許可權=管理权限
米糰=米糰
糊裡糊塗=胡里胡涂
索馬利亞=索马里
紮下=紮下
紮好=紮好
紮實=紮实
紮營=紮营
紮緊=紮紧
紮起=紮起
組合語言=汇编语言
組合語言程式=汇编语言程序
網路=网络
老字型大小=老字号
老態龍鍾=老态龙钟
耶誕節=圣诞节
舖子=舖子
舖頭=舖头
航太=航天
航太事業=航天事业
航太專家=航天专家
航太工業=航天工业
良性迴圈=良性循环
色慾=色慾
葦蓆=苇蓆
蒐求=蒐求
蒐羅=蒐罗
蒐證=蒐证
蒐購=蒐购
蒐集=蒐集
蓆草=蓆草
藉以=借以
藉口=借口
藉故=借故
螢幕=屏幕
衣襬=衣摆
表像=表象
表單=窗体
表示支援=表示支持
裏舖=里舖
補數=补码
西元=公元
西元前=公元前
觔斗=筋斗
解析度=分辨率
計程車=出租车
記憶體=内存
許可權=权限
註腳=脚注
諮詢=咨询
變數=变量
財慾=财慾
貪慾=贪慾
資料檔案=数据文件
資訊=信息
賓士=奔驰
超連結=超级链接
跼踀=局促
蹺課=逃课
身歷聲=立体声
軟盤機=软驱
軟硬體=软硬件
軟碟=软盘
軟體=软件
軟體發展包=软件开发包
載入=加载
轉捩點=转折点
辟穀=辟穀
迪斯可=迪斯科
迴圈=循环
速食麵=方便面
連線=联机
週邊=外围
運算式=表达式
達成協定=达成协议
遮罩=屏蔽
金舖=金舖
鉅萬=钜万
銀舖=银舖
錄影=录像
鍛鍊=锻链
鍾情=钟情
鍾愛=钟爱
鏈結=链接
鐳射=激光
闢地=闢地
雜貨舖=杂货舖
電晶體=晶体管
音效卡=声卡
顯像管=显象管
風乾=风乾
颳起=飓起
食具=餐具
飯舖=饭舖
驅動程式=驱动程序
骯髒=肮脏
鳳梨=菠萝
鵰鴞=雕鸮
麵糰=面团
點陣字形檔=点阵字库