0只支持=0只支持
0只支援=0只支援
0周后=0周後
0多只=0多隻
0天后=0天後
0年=0年
0只=0隻
0余=0餘
1只支持=1只支持
1只支援=1只支援
1周后=1周後
1天后=1天後
1年=1年
1只=1隻
1余=1餘
2只支持=2只支持
2只支援=2只支援
2周后=2周後
2天后=2天後
2年=2年
2只=2隻
2余=2餘
3只支持=3只支持
3只支援=3只支援
3周后=3周後
3天后=3天後
3年=3年
3只=3隻
3余=3餘
4只支持=4只支持
4只支援=4只支援
4周后=4周後
4天后=4天後
4年=4年
4只=4隻
4余=4餘
5只支持=5只支持
5只支援=5只支援
5周后=5周後
5天后=5天後
5年=5年
5只=5隻
5余=5餘
6只支持=6只支持
6只支援=6只支援
6周后=6周後
6天后=6天後
6年=6年
6只=6隻
6余=6餘
7只支持=7只支持
7只支援=7只支援
7周后=7周後
7天后=7天後
7年=7年
7只=7隻
7余=7餘
8只支持=8只支持
8只支援=8只支援
8周后=8周後
8天后=8天後
8年=8年
8只=8隻
8余=8餘
9只支持=9只支持
9只支援=9只支援
9周后=9周後
9天后=9天後
9年=9年
9只=9隻
9余=9餘
·范=·范
、克制=、剋制
。克制=。剋制
〇周后=〇周後
〇年=〇年
〇只=〇隻
〇余=〇餘
一干二净=一乾二淨
一伙人=一伙人
一伙头=一伙頭
一伙食=一伙食
一并=一併
一个=一個
一个准=一個準
一出刊=一出刊
一出口=一出口
一出版=一出版
一出生=一出生
一出祁山=一出祁山
一出逃=一出逃
一划=一划
一半只=一半只
一吊錢=一吊錢
一吊钱=一吊錢
一周后=一周後
一地里=一地裡
一伙=一夥
一天后=一天後
一天钟=一天鐘
一干人=一干人
一干家中=一干家中
一干弟兄=一干弟兄
一干弟子=一干弟子
一干部下=一干部下
一年=一年
一年里=一年裡
一吊=一弔
一别头=一彆頭
一斗斗=一斗斗
一树百获=一樹百穫
一准=一準
一争两丑=一爭兩醜
一物克一物=一物剋一物
一目了然=一目了然
一扎=一紮
一冲=一衝
一锅面=一鍋麵
一只=一隻
一面食=一面食
一头长发=一頭長髮
一余=一餘
一发千钧=一髮千鈞
一哄而散=一鬨而散
一出子=一齣子
丁丁当当=丁丁當當
丁丑=丁丑
七个=七個
七出刊=七出刊
七出口=七出口
七出版=七出版
七出生=七出生
七出祁山=七出祁山
七出逃=七出逃
七周后=七周後
七天后=七天後
七年=七年
七情六欲=七情六慾
七扎=七紮
七只=七隻
七余=七餘
万俟=万俟
万旗=万旗
三个=三個
三出刊=三出刊
三出口=三出口
三出版=三出版
三出生=三出生
三出祁山=三出祁山
三出逃=三出逃
三周后=三周後
三天后=三天後
三年=三年
三征七辟=三徵七辟
三准=三準
三扎=三紮
三统历=三統曆
三统历史=三統歷史
三复=三複
三只=三隻
三余=三餘
上梁山=上梁山
上梁=上樑
上签名=上簽名
上签字=上簽字
上签写=上簽寫
上签收=上簽收
上签=上籤
上药=上藥
上课钟=上課鐘
上面糊=上面糊
下仑路=下崙路
下于=下於
下梁=下樑
下注解=下注解
下签名=下簽名
下签字=下簽字
下签写=下簽寫
下签收=下簽收
下签=下籤
下药=下藥
下课钟=下課鐘
不干不净=不乾不淨
不占=不佔
不克自制=不克自制
不准他=不准他
不准你=不准你
不准她=不准她
不准它=不准它
不准我=不准我
不准没=不准沒
不准翻印=不准翻印
不准许=不准許
不准谁=不准誰
不克制=不剋制
不加自制=不加自制
不占凶吉=不占凶吉
不占卜=不占卜
不占吉凶=不占吉凶
不占算=不占算
不只=不只
不好干涉=不好干涉
不好干预=不好干預
不好干預=不好干預
不嫌母丑=不嫌母醜
不寒而栗=不寒而慄
不干事=不干事
不干他=不干他
不干休=不干休
不干你=不干你
不干她=不干她
不干它=不干它
不干我=不干我
不干擾=不干擾
不干扰=不干擾
不干涉=不干涉
不干牠=不干牠
不干犯=不干犯
不干预=不干預
不干預=不干預
不干=不幹
不吊=不弔
不采=不採
不斗膽=不斗膽
不斗胆=不斗膽
不断发=不斷發
不每只=不每只
不准=不準
不准确=不準確
不谷=不穀
不药而愈=不藥而癒
不托=不託
不负所托=不負所托
不通吊庆=不通弔慶
不丑=不醜
不采声=不采聲
不采聲=不采聲
不锈钢=不鏽鋼
不食干腊=不食乾腊
不斗=不鬥
丑三=丑三
丑婆子=丑婆子
丑年=丑年
丑日=丑日
丑旦=丑旦
丑时=丑時
丑月=丑月
丑表功=丑表功
丑角=丑角
且于=且於
世田谷=世田谷
世界杯=世界盃
世界里=世界裡
世纪钟=世紀鐘
世纪钟表=世紀鐘錶
丢丑=丟醜
并不准=並不准
并不准确=並不準確
并存着=並存著
并曰入淀=並曰入澱
并发动=並發動
并发展=並發展
并发布=並發布
并发现=並發現
并发表=並發表
并行=並行
中国国际信托投资公司=中國國際信托投資公司
中型钟=中型鐘
中型钟表面=中型鐘表面
中型钟表=中型鐘錶
中型钟面=中型鐘面
中仑=中崙
中岳=中嶽
中庄子=中庄子
中文里=中文裡
中于=中於
中签=中籤
中美发表=中美發表
中药=中藥
中西合并=中西合併
中风后=中風後
丰儀=丰儀
丰仪=丰儀
丰南=丰南
丰台=丰台
丰姿=丰姿
丰容=丰容
丰度=丰度
丰情=丰情
丰标=丰標
丰標不凡=丰標不凡
丰标不凡=丰標不凡
丰神=丰神
丰茸=丰茸
丰采=丰采
丰韵=丰韻
丰韻=丰韻
丸药=丸藥
丹药=丹藥
主仆=主僕
主干=主幹
主钟差=主鐘差
主钟曲线=主鐘曲線
么么小丑=么麼小丑
之一只=之一只
之二只=之二只
之八九只=之八九只
之征=之徵
之托=之託
之钟=之鐘
之余=之餘
乙丑=乙丑
九世之仇=九世之讎
九个=九個
九出刊=九出刊
九出口=九出口
九出版=九出版
九出生=九出生
九出祁山=九出祁山
九出逃=九出逃
九周后=九周後
九天后=九天後
九年=九年
九谷=九穀
九扎=九紮
九只=九隻
九余=九餘
九龙表行=九龍表行
九龍表行=九龍表行
也克制=也剋制
也斗了胆=也斗了膽
干干=乾乾
干干儿的=乾乾兒的
干干净净=乾乾淨淨
干井=乾井
干个够=乾個夠
干儿=乾兒
干冰=乾冰
干冷=乾冷
干刻版=乾刻版
干剥剥=乾剝剝
干卦=乾卦
干吊着下巴=乾吊著下巴
干和=乾和
干咳=乾咳
干咽=乾咽
干哥=乾哥
干哭=乾哭
干唱=乾唱
干啼=乾啼
干乔=乾喬
干呕=乾嘔
干哕=乾噦
干嚎=乾嚎
干回付=乾回付
干圆洁净=乾圓潔淨
干地=乾地
干坤=乾坤
干坞=乾塢
干女=乾女
干奴才=乾奴才
干妹=乾妹
干姊=乾姊
干娘=乾娘
干妈=乾媽
干子=乾子
干季=乾季
干尸=乾屍
干屎橛=乾屎橛
干巴=乾巴
干式=乾式
干弟=乾弟
干急=乾急
干性=乾性
干打雷=乾打雷
干折=乾折
干撂台=乾撂台
干撇下=乾撇下
干擦=乾擦
干支剌=乾支剌
干支支=乾支支
干敲梆子不卖油=乾敲梆子不賣油
干料=乾料
干旱=乾旱
干暖=乾暖
干材=乾材
干村沙=乾村沙
干杯=乾杯
干果=乾果
干枯=乾枯
干柴=乾柴
干柴烈火=乾柴烈火
干梅=乾梅
干死=乾死
干池=乾池
干没=乾沒
干洗=乾洗
干涸=乾涸
干凉=乾涼
干净=乾淨
干渠=乾渠
干渴=乾渴
干沟=乾溝
干漆=乾漆
干涩=乾澀
干湿=乾濕
干熬=乾熬
干热=乾熱
干熱=乾熱
干灯盏=乾燈盞
干燥=乾燥
干爸=乾爸
干爹=乾爹
干爽=乾爽
干片=乾片
干生受=乾生受
干生子=乾生子
干产=乾產
干田=乾田
干疥=乾疥
干瘦=乾瘦
干瘪=乾癟
干癣=乾癬
干瘾=乾癮
干白儿=乾白兒
干的=乾的
干眼=乾眼
干瞪眼=乾瞪眼
干礼=乾禮
干稿=乾稿
干笑=乾笑
干等=乾等
干篾片=乾篾片
干粉=乾粉
干粮=乾糧
干结=乾結
干丝=乾絲
干纲=乾綱
干绷=乾繃
干耗=乾耗
干肉片=乾肉片
干股=乾股
干肥=乾肥
干脆=乾脆
干花=乾花
干刍=乾芻
干苔=乾苔
干茨腊=乾茨臘
干茶钱=乾茶錢
干草=乾草
干菜=乾菜
干落=乾落
干着=乾著
干姜=乾薑
干薪=乾薪
干虔=乾虔
干号=乾號
干血浆=乾血漿
干衣=乾衣
干裂=乾裂
干亲=乾親
乾象历=乾象曆
乾象曆=乾象曆
干贝=乾貝
干货=乾貨
干躁=乾躁
干逼=乾逼
干酪=乾酪
干酵母=乾酵母
干醋=乾醋
干重=乾重
干量=乾量
干阿奶=乾阿奶
干隆=乾隆
干雷=乾雷
干电=乾電
干霍乱=乾霍亂
干颡=乾顙
干台=乾颱
干饭=乾飯
干馆=乾館
干糇=乾餱
干馏=乾餾
干鱼=乾魚
干鲜=乾鮮
干面=乾麵
乱发=亂髮
乱哄=亂鬨
乱哄不过来=亂鬨不過來
了克制=了剋制
了然后=了然後
事情干脆=事情干脆
事有斗巧=事有鬥巧
事迹=事迹
事都干脆=事都干脆
二不棱登=二不稜登
二个=二個
二出刊=二出刊
二出口=二出口
二出版=二出版
二出生=二出生
二出祁山=二出祁山
二出逃=二出逃
二只得=二只得
二周后=二周後
二天后=二天後
二仑=二崙
二年=二年
二缶钟惑=二缶鐘惑
二老板=二老板
二虎相斗=二虎相鬥
二里头=二里頭
二里頭=二里頭
二只=二隻
二余=二餘
于丹=于丹
于于=于于
于仁泰=于仁泰
于仲文=于仲文
于佳卉=于佳卉
于来山=于來山
于伟国=于偉國
于偉國=于偉國
于光新=于光新
于光远=于光遠
于光遠=于光遠
于克-蘭多縣=于克-蘭多縣
于克-兰多县=于克-蘭多縣
于克勒=于克勒
于再清=于再清
于冕=于冕
于冠华=于冠華
于凌奎=于凌奎
于凌辰=于凌辰
于勒=于勒
于化虎=于化虎
于占元=于占元
于友泽=于友澤
于台煙=于台煙
于台烟=于台煙
于右任=于右任
于吉=于吉
于和伟=于和偉
于品海=于品海
于国桢=于國楨
于國楨=于國楨
于国治=于國治
于國治=于國治
于坚=于堅
于堅=于堅
于大寶=于大寶
于大宝=于大寶
于天仁=于天仁
于天龙=于天龍
于奇库杜克=于奇庫杜克
于奇庫杜克=于奇庫杜克
于姓=于姓
于娜=于娜
于娟=于娟
于子千=于子千
于孔兼=于孔兼
于學忠=于學忠
于学忠=于學忠
于家堡=于家堡
于寘=于寘
于小伟=于小偉
于小偉=于小偉
于小彤=于小彤
于小惠=于小惠
于少保=于少保
于山=于山
于山国=于山國
于山國=于山國
于帥=于帥
于帅=于帥
于幼軍=于幼軍
于幼军=于幼軍
于康震=于康震
于廣洲=于廣洲
于广洲=于廣洲
于式枚=于式枚
于從濂=于從濂
于从濂=于從濂
于德海=于德海
于志宁=于志寧
于志寧=于志寧
于忠肃集=于忠肅集
于思=于思
于慎行=于慎行
于慧=于慧
于成龙=于成龍
于成龍=于成龍
于振=于振
于振武=于振武
于敏=于敏
于敏中=于敏中
于斌=于斌
于斯塔德=于斯塔德
于斯纳尔斯贝里=于斯納爾斯貝里
于斯納爾斯貝里=于斯納爾斯貝里
于斯达尔=于斯達爾
于斯達爾=于斯達爾
于明涛=于明濤
于明濤=于明濤
于是之=于是之
于晨楠=于晨楠
于晴=于晴
于會泳=于會泳
于会泳=于會泳
于根伟=于根偉
于根偉=于根偉
于格=于格
于楓=于楓
于枫=于楓
于荣光=于榮光
于樂=于樂
于树洁=于樹潔
于樹潔=于樹潔
于欣=于欣
于欣源=于欣源
于正升=于正昇
于正昇=于正昇
于正昌=于正昌
于归=于歸
于氏=于氏
于永波=于永波
于江震=于江震
于波=于波
于洋=于洋
于洪区=于洪區
于洪區=于洪區
于浩威=于浩威
于海=于海
于海洋=于海洋
于湘兰=于湘蘭
于湘蘭=于湘蘭
于漢超=于漢超
于汉超=于漢超
于澄=于澄
于泽尔=于澤爾
于澤爾=于澤爾
于涛=于濤
于濤=于濤
于熙珍=于熙珍
于爾岑=于爾岑
于尔岑=于爾岑
于爾根=于爾根
于尔根=于爾根
于尔里克=于爾里克
于爾里克=于爾里克
于特森=于特森
于玉立=于玉立
于田=于田
于禁=于禁
于秀敏=于秀敏
于立成=于立成
于素秋=于素秋
于美人=于美人
于耘婕=于耘婕
于若木=于若木
于蔭霖=于蔭霖
于荫霖=于蔭霖
于衡=于衡
于西翰=于西翰
于謙=于謙
于谦=于謙
于谨=于謹
于貝爾=于貝爾
于贝尔=于貝爾
于赠=于贈
于贈=于贈
于越=于越
于军=于軍
于軍=于軍
于道泉=于道泉
于远伟=于遠偉
于遠偉=于遠偉
于都縣=于都縣
于都县=于都縣
于里察=于里察
于阗=于闐
于雙戈=于雙戈
于双戈=于雙戈
于云鹤=于雲鶴
于震=于震
于震寰=于震寰
于震环=于震環
于震環=于震環
于靖=于靖
于非闇=于非闇
于韋斯屈萊=于韋斯屈萊
于韦斯屈莱=于韋斯屈萊
于风政=于風政
于風政=于風政
于飞=于飛
于飛島=于飛島
于飞岛=于飛島
于余曲折=于餘曲折
于鬯=于鬯
于魁智=于魁智
于凤桐=于鳳桐
于鳳桐=于鳳桐
于凤至=于鳳至
于鳳至=于鳳至
于默奥=于默奧
于默奧=于默奧
云乎=云乎
云云=云云
云何=云何
云为=云為
云為=云為
云然=云然
云尔=云爾
云：=云：
五个=五個
五出刊=五出刊
五出口=五出口
五出版=五出版
五出生=五出生
五出祁山=五出祁山
五出逃=五出逃
五周后=五周後
五天后=五天後
五岳=五嶽
五年=五年
五谷=五穀
五扎=五紮
五行生克=五行生剋
五谷王北街=五谷王北街
五谷王南街=五谷王南街
五只=五隻
五余=五餘
五出=五齣
井干摧败=井榦摧敗
井里=井裡
亚于=亞於
亚美尼亚历=亞美尼亞曆
交托=交託
交游=交遊
交哄=交鬨
亦云=亦云
亦庄亦谐=亦莊亦諧
亮丑=亮醜
亮钟=亮鐘
人云=人云
人参加=人參加
人参展=人參展
人参战=人參戰
人参拜=人參拜
人参政=人參政
人参照=人參照
人参看=人參看
人参禅=人參禪
人参考=人參考
人参与=人參與
人参见=人參見
人参观=人參觀
人参谋=人參謀
人参议=人參議
人参赞=人參贊
人参透=人參透
人参选=人參選
人参酌=人參酌
人参阅=人參閱
人如风后入江云=人如風後入江雲
人欲=人慾
人物志=人物誌
人参=人蔘
什锦面=什錦麵
什么=什麼
仇仇=仇讎
今天=今天
他克制=他剋制
他钟=他鐘
付托=付託
仙后=仙后
仙药=仙藥
代码表=代碼表
代表=代表
令人发指=令人髮指
以自制=以自制
仰药=仰藥
件钟=件鐘
任何表演=任何表演
任何表示=任何表示
任何表達=任何表達
任何表达=任何表達
任何表=任何錶
任何钟=任何鐘
任何钟表=任何鐘錶
任教于=任教於
任于=任於
仿制=仿製
伊于湖底=伊于湖底
伊府面=伊府麵
伊斯兰教历=伊斯蘭教曆
伊斯兰教历史=伊斯蘭教歷史
伊斯兰历=伊斯蘭曆
伊斯兰历史=伊斯蘭歷史
伊东怜=伊東怜
伊尔汗历表=伊爾汗曆表
伊达里子=伊達里子
伊适杰=伊適杰
伊里布=伊里布
伊郁=伊鬱
伏几=伏几
伐罪吊民=伐罪弔民
休征=休徵
伙头=伙頭
伴游=伴遊
似于=似於
但云=但云
布于=佈於
布道=佈道
布雷、=佈雷、
布雷。=佈雷。
布雷封锁=佈雷封鎖
布雷的=佈雷的
布雷艇=佈雷艇
布雷舰=佈雷艦
布雷速度=佈雷速度
布雷，=佈雷，
布雷；=佈雷；
位于=位於
位准=位準
低洼=低洼
住扎=住紮
占0=佔0
占1=佔1
占2=佔2
占3=佔3
占4=佔4
占5=佔5
占6=佔6
占7=佔7
占8=佔8
占9=佔9
占A=佔A
占B=佔B
占C=佔C
占D=佔D
占E=佔E
占F=佔F
占G=佔G
占H=佔H
占I=佔I
占J=佔J
占K=佔K
占L=佔L
占M=佔M
占N=佔N
占O=佔O
占P=佔P
占Q=佔Q
占R=佔R
占S=佔S
占T=佔T
占U=佔U
占V=佔V
占W=佔W
占X=佔X
占Y=佔Y
占Z=佔Z
占a=佔a
占b=佔b
占c=佔c
占d=佔d
占e=佔e
占f=佔f
占g=佔g
占h=佔h
占i=佔i
占j=佔j
占k=佔k
占l=佔l
占m=佔m
占n=佔n
占o=佔o
占p=佔p
占q=佔q
占r=佔r
占s=佔s
占t=佔t
占u=佔u
占v=佔v
占w=佔w
占x=佔x
占y=佔y
占z=佔z
占〇=佔〇
占一=佔一
占七=佔七
占万=佔万
占三=佔三
占上风=佔上風
占下=佔下
占下风=佔下風
占不占=佔不佔
占不足=佔不足
占世界=佔世界
占中=佔中
占主=佔主
占九=佔九
占了=佔了
占二=佔二
占五=佔五
占人便宜=佔人便宜
占位=佔位
占住=佔住
占占=佔佔
占便宜=佔便宜
占俄=佔俄
占个=佔個
占个位=佔個位
占停车=佔停車
占亿=佔億
占优=佔優
占先=佔先
占光=佔光
占全=佔全
占两=佔兩
占八=佔八
占六=佔六
占分=佔分
占到=佔到
占加=佔加
占劣=佔劣
占北=佔北
占十=佔十
占千=佔千
占半=佔半
占南=佔南
占印=佔印
占去=佔去
占取=佔取
占台=佔台
占哺乳=佔哺乳
占嗫=佔囁
占四=佔四
占国内=佔國內
占在=佔在
占地=佔地
占场=佔場
占压=佔壓
占多=佔多
占大=佔大
占好=佔好
占小=佔小
占少=佔少
占局部=佔局部
占屋=佔屋
占山=佔山
占市场=佔市場
占平均=佔平均
占床=佔床
占座=佔座
占后=佔後
占得=佔得
占德=佔德
占掉=佔掉
占据=佔據
占整体=佔整體
占新=佔新
占有=佔有
占有欲=佔有慾
占东=佔東
占查=佔查
占次=佔次
占比=佔比
占法=佔法
占满=佔滿
占澳=佔澳
占为=佔為
占率=佔率
占用=佔用
占毕=佔畢
占百=佔百
占尽=佔盡
占稳=佔穩
占网=佔網
占线=佔線
占总=佔總
占缺=佔缺
占美=佔美
占耕=佔耕
占至多=佔至多
占至少=佔至少
占英=佔英
占着=佔著
占葡=佔葡
占苏=佔蘇
占西=佔西
占资源=佔資源
占起=佔起
占超过=佔超過
占过=佔過
占道=佔道
占零=佔零
占領=佔領
占领=佔領
占头=佔頭
占头筹=佔頭籌
占饭=佔飯
占香=佔香
占马=佔馬
占高枝儿=佔高枝兒
占０=佔０
占１=佔１
占２=佔２
占３=佔３
占４=佔４
占５=佔５
占６=佔６
占７=佔７
占８=佔８
占９=佔９
占Ａ=佔Ａ
占Ｂ=佔Ｂ
占Ｃ=佔Ｃ
占Ｄ=佔Ｄ
占Ｅ=佔Ｅ
占Ｆ=佔Ｆ
占Ｇ=佔Ｇ
占Ｈ=佔Ｈ
占Ｉ=佔Ｉ
占Ｊ=佔Ｊ
占Ｋ=佔Ｋ
占Ｌ=佔Ｌ
占Ｍ=佔Ｍ
占Ｎ=佔Ｎ
占Ｏ=佔Ｏ
占Ｐ=佔Ｐ
占Ｑ=佔Ｑ
占Ｒ=佔Ｒ
占Ｓ=佔Ｓ
占Ｔ=佔Ｔ
占Ｕ=佔Ｕ
占Ｖ=佔Ｖ
占Ｗ=佔Ｗ
占Ｘ=佔Ｘ
占Ｙ=佔Ｙ
占Ｚ=佔Ｚ
占ａ=佔ａ
占ｂ=佔ｂ
占ｃ=佔ｃ
占ｄ=佔ｄ
占ｅ=佔ｅ
占ｆ=佔ｆ
占ｇ=佔ｇ
占ｈ=佔ｈ
占ｉ=佔ｉ
占ｊ=佔ｊ
占ｋ=佔ｋ
占ｌ=佔ｌ
占ｍ=佔ｍ
占ｎ=佔ｎ
占ｏ=佔ｏ
占ｐ=佔ｐ
占ｑ=佔ｑ
占ｒ=佔ｒ
占ｓ=佔ｓ
占ｔ=佔ｔ
占ｕ=佔ｕ
占ｖ=佔ｖ
占ｗ=佔ｗ
占ｘ=佔ｘ
占ｙ=佔ｙ
占ｚ=佔ｚ
何杰=何杰
余三胜=余三勝
余三勝=余三勝
余光中=余光中
余光生=余光生
余力為=余力為
余力为=余力為
余姓=余姓
余威德=余威德
余子明=余子明
余思敏=余思敏
佛罗棱萨=佛羅稜薩
佛钟=佛鐘
作品里=作品裡
作奸犯科=作姦犯科
作准=作準
作庄=作莊
你克制=你剋制
你斗了胆=你斗了膽
你才子发昏=你纔子發昏
佣金收益=佣金收益
佣金费用=佣金費用
佳肴=佳肴
佳里鎮=佳里鎮
并一不二=併一不二
并入=併入
并兼=併兼
并到=併到
并合=併合
并名=併名
并吞下=併吞下
并拢=併攏
并案=併案
并流=併流
并火=併火
并为一家=併為一家
并为一体=併為一體
并产=併產
并当=併當
并叠=併疊
并发型模式=併發型模式
并发模式=併發模式
并发症=併發症
并发重症=併發重症
并科=併科
并网=併網
并线=併線
并肩子=併肩子
并购=併購
并除=併除
并骨=併骨
使其斗=使其鬥
来于=來於
来复=來複
侍仆=侍僕
供制=供製
依依不舍=依依不捨
依托=依託
侵占=侵佔
侵并=侵併
侵占到=侵占到
侵占罪=侵占罪
便药=便藥
系数=係數
系为=係為
俄占=俄佔
保险柜=保險柜
信托贸易=信托貿易
信托=信託
修杰楷=修杰楷
修杰麟=修杰麟
修炼=修鍊
修胡刀=修鬍刀
俯冲=俯衝
个人=個人
个里=個裡
个钟=個鐘
个钟表=個鐘錶
们克制=們剋制
们斗了胆=們斗了膽
倒绷孩儿=倒繃孩兒
幸免=倖免
幸存=倖存
幸幸=倖幸
候复=候覆
倛丑=倛醜
借听于聋=借聽於聾
倦游=倦遊
假药=假藥
假托=假託
假发=假髮
偎干=偎乾
做庄=做莊
停停当当=停停當當
停征=停徵
停制=停製
偷鸡不着=偷雞不著
伪药=偽藥
备注=備註
家伙=傢伙
家俱=傢俱
家具=傢具
催并=催併
佣中佼佼=傭中佼佼
佣人=傭人
佣仆=傭僕
佣兵=傭兵
佣工=傭工
佣懒=傭懶
佣书=傭書
佣金=傭金
傲游=傲遊
傲霜斗雪=傲霜鬥雪
传位于四太子=傳位于四太子
傳位于四太子=傳位于四太子
传于=傳於
伤痕累累=傷痕纍纍
傻里傻气=傻裡傻氣
倾复=傾複
仆人=僕人
仆使=僕使
仆仆=僕僕
仆僮=僕僮
仆吏=僕吏
仆固怀恩=僕固懷恩
仆夫=僕夫
仆姑=僕姑
仆婢=僕婢
仆妇=僕婦
仆射=僕射
仆少=僕少
仆役=僕役
仆从=僕從
仆憎=僕憎
仆欧=僕歐
仆程=僕程
仆虽罢驽=僕雖罷駑
侥幸=僥倖
僮仆=僮僕
雇主=僱主
雇人=僱人
雇佣=僱傭
雇到=僱到
雇员=僱員
雇工=僱工
雇用=僱用
雇农=僱農
仪范=儀範
仪表=儀錶
亿个=億個
亿周后=億周後
亿多只=億多隻
亿天后=億天後
亿年=億年
亿只=億隻
亿余=億餘
俭仆=儉僕
俭朴=儉樸
俭确之教=儉确之教
儒略改革历=儒略改革曆
儒略改革历史=儒略改革歷史
儒略历=儒略曆
儒略历史=儒略歷史
尽尽=儘儘
尽先=儘先
尽其所有=儘其所有
尽力=儘力
尽可能=儘可能
尽快=儘快
尽早=儘早
尽是=儘是
尽管=儘管
尽速=儘速
优于=優於
优游=優遊
兀术=兀朮
元凶=元兇
充饥=充饑
兆个=兆個
兆余=兆餘
凶刀=兇刀
凶器=兇器
凶嫌=兇嫌
凶巴巴=兇巴巴
凶徒=兇徒
凶悍=兇悍
凶恶=兇惡
凶手=兇手
凶案=兇案
凶枪=兇槍
凶横=兇橫
凶殘=兇殘
凶残=兇殘
凶殺=兇殺
凶杀=兇殺
凶犯=兇犯
凶狠=兇狠
凶猛=兇猛
凶疑=兇疑
凶相=兇相
凶险=兇險
先占=先佔
先采=先採
光致致=光緻緻
克药=克藥
克复=克複
免征=免徵
党参=党參
党太尉=党太尉
党怀英=党懷英
党进=党進
党項=党項
党项=党項
内制=內製
内面包=內面包
内面包的=內面包的
内斗=內鬥
内哄=內鬨
全干=全乾
全面包围=全面包圍
全面包裹=全面包裹
两个=兩個
两周后=兩周後
两天后=兩天後
两天晒网=兩天晒網
两年=兩年
两扎=兩紮
两虎共斗=兩虎共鬥
两只=兩隻
两余=兩餘
两鼠斗穴=兩鼠鬥穴
八个=八個
八出刊=八出刊
八出口=八出口
八出版=八出版
八出生=八出生
八出祁山=八出祁山
八出逃=八出逃
八周后=八周後
八天后=八天後
八字胡=八字鬍
八年=八年
八扎=八紮
八蜡=八蜡
八只=八隻
八余=八餘
公仔面=公仔麵
公仆=公僕
公孙丑=公孫丑
公干=公幹
公历=公曆
公历史=公歷史
公厘=公釐
公余=公餘
六个=六個
六出刊=六出刊
六出口=六出口
六出版=六出版
六出生=六出生
六出祁山=六出祁山
六出逃=六出逃
六周后=六周後
六天后=六天後
六年=六年
六谷=六穀
六扎=六紮
六冲=六衝
六只=六隻
六余=六餘
六出=六齣
共和历=共和曆
共和历史=共和歷史
其一只=其一只
其二只=其二只
其八九只=其八九只
其次辟地=其次辟地
其余=其餘
典范=典範
兼并=兼并
冉有仆=冉有僕
冗余=冗餘
冤仇=冤讎
冥蒙=冥濛
冬天里=冬天裡
冬山庄=冬山庄
冬日里=冬日裡
冬游=冬遊
冰冷=冰冷
冶游=冶遊
冷庄子=冷莊子
冷面相=冷面相
冷面=冷麵
准三后=准三后
准不准他=准不准他
准不准你=准不准你
准不准她=准不准她
准不准它=准不准它
准不准我=准不准我
准不准许=准不准許
准不准谁=准不准誰
准保護=准保護
准保护=准保護
准保释=准保釋
准保釋=准保釋
凌蒙初=凌濛初
凝炼=凝鍊
几上=几上
几几=几几
几凳=几凳
几子=几子
几旁=几旁
几杖=几杖
几案=几案
几椅=几椅
几榻=几榻
几净窗明=几淨窗明
几筵=几筵
几丝=几絲
几面上=几面上
凶杀案=凶殺案
凶相毕露=凶相畢露
凹洞里=凹洞裡
出乖弄丑=出乖弄醜
出乖露丑=出乖露醜
出征收=出征收
出于=出於
出游=出遊
出丑=出醜
出锤=出鎚
分占=分佔
分别致=分别致
分半钟=分半鐘
分多钟=分多鐘
分子钟=分子鐘
分子云=分子雲
分布圖=分布圖
分布图=分布圖
分布于=分布於
分散于=分散於
分钟=分鐘
刑余=刑餘
划一桨=划一槳
划上=划上
划下=划下
划不来=划不來
划了=划了
划了一会=划了一會
划来划去=划來划去
划具=划具
划出=划出
划到=划到
划到岸=划到岸
划到江心=划到江心
划动=划動
划去=划去
划子=划子
划得来=划得來
划拳=划拳
划桨=划槳
划槳=划槳
划水=划水
划算=划算
划船=划船
划艇=划艇
划着=划著
划着走=划著走
划行=划行
划走=划走
划起=划起
划进=划進
划进来=划進來
划进去=划進去
划过=划過
划过来=划過來
划过去=划過去
划龙舟=划龍舟
判断发=判斷發
别日南鸿才北去=別日南鴻纔北去
别致=別緻
别庄=別莊
别着=別著
别辟=別闢
利欲=利慾
利于=利於
利欲熏心=利欲熏心
刮来刮去=刮來刮去
刮着=刮著
刮起来=刮起來
刮风下雪倒便宜=刮風下雪倒便宜
刮胡=刮鬍
制冷机=制冷機
制签=制籤
制钟=制鐘
刺绣=刺繡
刻半钟=刻半鐘
刻多钟=刻多鐘
刻钟=刻鐘
剃发=剃髮
剃胡=剃鬍
剃须=剃鬚
削发=削髮
削面=削麵
克制不了=剋制不了
克制不住=剋制不住
克扣=剋扣
克星=剋星
克期=剋期
克死=剋死
克薄=剋薄
前天=前天
前往=前往
前言不答后语=前言不答後語
前面店=前面店
剔庄货=剔莊貨
刚干=剛乾
刚雇=剛僱
刚才一载=剛纔一載
剥制=剝製
剩余=剩餘
剪其发=剪其髮
剪牡丹喂牛=剪牡丹喂牛
剪彩=剪綵
剪发=剪髮
割舍=割捨
创获=創穫
创制=創製
铲出=剷出
铲刈=剷刈
铲平=剷平
铲除=剷除
铲头=剷頭
划入=劃入
划为=劃為
剧药=劇藥
刘佳怜=劉佳怜
劉佳怜=劉佳怜
刘克庄=劉克莊
刘芸后=劉芸后
力克制=力剋制
力拼=力拚
力拼众敌=力拼眾敵
力求克制=力求剋制
力争上游=力爭上遊
功致=功緻
加氢精制=加氫精制
加药=加藥
加注=加註
劣于=劣於
助于=助於
劫余=劫餘
勃郁=勃鬱
动荡=動蕩
胜于=勝於
劳力士表=勞力士錶
勤仆=勤僕
勤朴=勤樸
勋章=勳章
勺药=勺藥
勾干=勾幹
勾心斗角=勾心鬥角
勾魂荡魄=勾魂蕩魄
包括=包括
包准=包準
包谷=包穀
包扎=包紮
包庄=包莊
匏系=匏繫
化学家=化學家
北岳=北嶽
北回线=北迴線
北回铁路=北迴鐵路
匡复=匡複
匪干=匪幹
匿于=匿於
十个=十個
十出刊=十出刊
十出口=十出口
十出版=十出版
十出生=十出生
十出祁山=十出祁山
十出逃=十出逃
十周后=十周後
十多只=十多隻
十天后=十天後
十年=十年
十扎=十紮
十只=十隻
十余=十餘
十出=十齣
千个=千個
千只可=千只可
千只夠=千只夠
千只够=千只夠
千只怕=千只怕
千只能=千只能
千只足够=千只足夠
千只足夠=千只足夠
千周后=千周後
千多只=千多隻
千天后=千天後
千年=千年
千扎=千紮
千丝万缕=千絲萬縷
千回百折=千迴百折
千回百转=千迴百轉
千钧一发=千鈞一髮
千只=千隻
千余=千餘
升官发财=升官發財
半制品=半制品
半只可=半只可
半只够=半只夠
半于=半於
半只=半隻
协调=協調
协防=協防
南京钟=南京鐘
南京钟表=南京鐘錶
南宫适=南宮适
南屏晚钟=南屏晚鐘
南岳=南嶽
南筑=南筑
南回线=南迴線
南回铁路=南迴鐵路
南游=南遊
博汇=博彙
博采=博採
卜云吉=卜云吉
卞庄=卞莊
卞庄子=卞莊子
占了卜=占了卜
占便宜的是呆=占便宜的是獃
占卜=占卜
占多数=占多數
占有五不验=占有五不驗
占有权=占有權
印累绶若=印纍綬若
印制=印製
危于=危於
卵与石斗=卵與石鬥
卷须=卷鬚
厂部=厂部
厝薪于火=厝薪於火
原子钟=原子鐘
原钟=原鐘
历物之意=厤物之意
参合=參合
参考价值=參考價值
参与=參與
参与人员=參與人員
参与制=參與制
参与感=參與感
参与者=參與者
参观团=參觀團
参观团体=參觀團體
参阅=參閱
反朴=反樸
反冲=反衝
反复制=反複製
反复=反覆
反覆=反覆
取舍=取捨
受托=受託
口干=口乾
口干冒=口干冒
口干政=口干政
口干涉=口干涉
口干犯=口干犯
口干预=口干預
口燥唇干=口燥唇乾
口腹之欲=口腹之慾
口里=口裡
口试=口試
口钟=口鐘
古书云=古書云
古書云=古書云
古柯咸=古柯鹹
古朴=古樸
古语云=古語云
古語云=古語云
古迹=古迹
古钟=古鐘
古钟表=古鐘錶
另辟=另闢
叩钟=叩鐘
只占=只佔
只占卜=只占卜
只占吉=只占吉
只占神问卜=只占神問卜
只占算=只占算
只采=只採
只冲=只衝
只要功夫深，铁杵磨成锈花针=只要功夫深，鐵杵磨成鏽花針
只身上已=只身上已
只身上有=只身上有
只身上沒=只身上沒
只身上没=只身上沒
只身上無=只身上無
只身上无=只身上無
只身上的=只身上的
只身世=只身世
只身份=只身份
只身前=只身前
只身受=只身受
只身子=只身子
只身形=只身形
只身影=只身影
只身后=只身後
只身後=只身後
只身心=只身心
只身旁=只身旁
只身材=只身材
只身段=只身段
只身为=只身為
只身為=只身為
只身边=只身邊
只身邊=只身邊
只身首=只身首
只身体=只身體
只身體=只身體
只身高=只身高
只采声=只采聲
叮叮当当=叮叮噹噹
叮当=叮噹
可以克制=可以剋制
可紧可松=可緊可鬆
可自制=可自制
台子女=台子女
台子孙=台子孫
台州=台州
台布景=台布景
台历史=台歷史
台钟=台鐘
台面前=台面前
叱咤903=叱咤903
叱咤MY903=叱咤MY903
叱咤My903=叱咤My903
叱咤叱叱咤=叱咤叱叱咤
叱咤叱咤叱咤咤=叱咤叱咤叱咤咤
叱咤咤=叱咤咤
叱咤乐坛=叱咤樂壇
叱咤樂壇=叱咤樂壇
叶 恭弘=叶 恭弘
叶　恭弘=叶　恭弘
叶不二子=叶不二子
叶志穗=叶志穗
叶恭弘=叶恭弘
叶音=叶音
叶韵=叶韻
吃板刀面=吃板刀麵
吃着不尽=吃著不盡
吃姜=吃薑
吃药=吃藥
吃里扒外=吃裡扒外
吃里爬外=吃裡爬外
吃辣面=吃辣麵
吃错药=吃錯藥
各辟=各闢
各类钟=各類鐘
合伙人=合伙人
合伙=合夥
合并=合并
合府上=合府上
合采=合採
合历=合曆
合历史=合歷史
合准=合準
合着=合著
合著者=合著者
吉凶庆吊=吉凶慶弔
吊带裤=吊帶褲
吊挂着=吊掛著
吊杆=吊杆
吊着=吊著
吊裤=吊褲
吊裤带=吊褲帶
吊钟=吊鐘
同伙=同夥
同于=同於
同余=同餘
后冠=后冠
后北街=后北街
后土=后土
后妃=后妃
后姓=后姓
后安路=后安路
后平路=后平路
后座=后座
后母戊=后母戊
后海湾=后海灣
后海灣=后海灣
后瑞站=后瑞站
后稷=后稷
后羿=后羿
后街=后街
后角=后角
后丰=后豐
后豐=后豐
后里=后里
后发FK型星=后髮FK型星
后髮FK型星=后髮FK型星
后髮座=后髮座
后发座=后髮座
后发星系团=后髮星系團
后髮星系團=后髮星系團
吐哺捉发=吐哺捉髮
吐哺握发=吐哺握髮
向往来=向往來
向往常=向往常
向往日=向往日
向往时=向往時
向着=向著
吞并=吞併
吟游=吟遊
含齿戴发=含齒戴髮
吹干=吹乾
吹发=吹髮
吹胡=吹鬍
吾为之范我驰驱=吾爲之範我馳驅
吕后=呂后
呂后=呂后
呆呆傻傻=呆呆傻傻
呆呆挣挣=呆呆掙掙
呆呆獸=呆呆獸
呆呆兽=呆呆獸
呆呆笨笨=呆呆笨笨
呆致致=呆緻緻
呆里呆气=呆裡呆氣
周一=周一
周三=周三
周二=周二
周五=周五
周六=周六
周后=周后
周四=周四
周历=周曆
周杰伦=周杰倫
周杰倫=周杰倫
周历史=周歷史
周庄王=周莊王
周游=周遊
呼吁=呼籲
命中注定=命中注定
和克制=和剋制
和奸=和姦
咎征=咎徵
咕咕钟=咕咕鐘
咬姜呷醋=咬薑呷醋
咯当=咯噹
咳嗽药=咳嗽藥
哀吊=哀弔
哀挽=哀輓
品汇=品彙
哄堂大笑=哄堂大笑
员山庄=員山庄
哪里=哪裡
哭脏=哭髒
唁吊=唁弔
呗赞=唄讚
唇干=唇乾
唯一只=唯一只
唱游=唱遊
唾面自干=唾面自乾
唾余=唾餘
商历=商曆
商历史=商歷史
启发式=啟發式
啷当=啷噹
喂了一声=喂了一聲
善于=善於
喜向往=喜向往
喜欢表=喜歡錶
喜欢钟=喜歡鐘
喜欢钟表=喜歡鐘錶
喝干=喝乾
喧哄=喧鬨
丧钟=喪鐘
乔岳=喬嶽
单于=單于
单单于=單單於
单干=單幹
单打独斗=單打獨鬥
嗑药=嗑藥
嘀嗒的表=嘀嗒的錶
嘉谷=嘉穀
嘉肴=嘉肴
嘴里=嘴裡
恶心=噁心
噙齿戴发=噙齒戴髮
喷洒=噴洒
当啷=噹啷
当当=噹噹
噜苏=嚕囌
向导=嚮導
向往=嚮往
向应=嚮應
向迩=嚮邇
严云农=嚴云農
严于=嚴於
严丝合缝=嚴絲合縫
嚼谷=嚼穀
囉囉苏苏=囉囉囌囌
囉苏=囉囌
嘱托=囑託
四个=四個
四出刊=四出刊
四出口=四出口
四出征收=四出徵收
四出版=四出版
四出生=四出生
四出祁山=四出祁山
四出逃=四出逃
四分历=四分曆
四分历史=四分歷史
四周后=四周後
四天后=四天後
四年=四年
四舍五入=四捨五入
四舍六入=四捨六入
四扎=四紮
四只=四隻
四面包=四面包
四面钟=四面鐘
四余=四餘
四出=四齣
回采=回採
回旋加速=回旋加速
回历=回曆
回历史=回歷史
回丝=回絲
回着=回著
回荡=回蕩
回游=回遊
回阳荡气=回陽蕩氣
因于=因於
困倦起来=困倦起來
困兽之斗=困獸之鬥
困兽犹斗=困獸猶鬥
困斗=困鬥
固定制=固定制
固征=固徵
囿于=囿於
圈占=圈佔
圈子里=圈子裡
圈梁=圈樑
圈里=圈裡
国之桢干=國之楨榦
国于=國於
国历=國曆
国历代=國歷代
国历任=國歷任
国历来=國歷來
国历史=國歷史
国历届=國歷屆
国历经=國歷經
国仇=國讎
园里=園裡
园游会=園遊會
图里=圖裡
图鉴=圖鑑
土里=土裡
土制=土製
土霉素=土霉素
在制品=在制品
在克制=在剋制
在于=在於
地占=地佔
地克制=地剋制
地心历表=地心曆表
地方志=地方志
地志=地誌
地丑德齐=地醜德齊
坏于=坏於
坐如钟=坐如鐘
坐庄=坐莊
坐钟=坐鐘
坑里=坑裡
坤范=坤範
坦荡=坦蕩
坦荡荡=坦蕩蕩
坱郁=坱鬱
垂于=垂於
垂范=垂範
垂发=垂髮
型范=型範
埃及历=埃及曆
埃及历史=埃及歷史
埃及艳后=埃及豔后
埃荣冲=埃榮衝
埋头寻表=埋頭尋錶
埋头寻钟=埋頭尋鐘
埋头寻钟表=埋頭尋鐘錶
城里=城裡
埔裡社撫墾局=埔裏社撫墾局
埔裏社撫墾局=埔裏社撫墾局
埔里社抚垦局=埔裏社撫墾局
基干=基幹
基于=基於
基准=基準
坚致=堅緻
堙淀=堙澱
涂着=塗著
涂药=塗藥
塞耳盗钟=塞耳盜鐘
塞药=塞藥
墓志铭=墓志銘
墓志=墓誌
增辟=增闢
墨沈=墨沈
墨沈未干=墨瀋未乾
堕胎药=墮胎藥
垦复=墾複
垦辟=墾闢
垄断价格=壟斷價格
垄断资产=壟斷資產
垄断集团=壟斷集團
壮游=壯遊
壮面=壯麵
壹郁=壹鬱
壶里=壺裡
壸范=壼範
寿面=壽麵
夏于乔=夏于喬
夏于喬=夏于喬
夏天里=夏天裡
夏日里=夏日裡
夏历=夏曆
夏历史=夏歷史
夏游=夏遊
外强中干=外強中乾
外制=外製
多占=多佔
多半只=多半只
多只可=多只可
多只在=多只在
多只是=多只是
多只會=多只會
多只会=多只會
多只有=多只有
多只用=多只用
多只能=多只能
多只需=多只需
多周后=多周後
多天后=多天後
多于=多於
多冲=多衝
多丑=多醜
多只=多隻
多余=多餘
多么=多麼
夜光表=夜光錶
夜里=夜裡
夜游=夜遊
够克制=夠剋制
夢有五不占=夢有五不占
梦有五不占=夢有五不占
梦里=夢裡
梦游=夢遊
伙伴=夥伴
伙友=夥友
伙同=夥同
伙众=夥眾
伙计=夥計
大丑=大丑
大伙儿=大伙兒
大只可=大只可
大只在=大只在
大只是=大只是
大只会=大只會
大只有=大只有
大只能=大只能
大只需=大只需
大周后=大周后
大型钟=大型鐘
大型钟表面=大型鐘表面
大型钟表=大型鐘錶
大型钟面=大型鐘面
大伙=大夥
大干=大幹
大批涌到=大批湧到
大折儿=大摺兒
大明历=大明曆
大明历史=大明歷史
大历=大曆
大本钟=大本鐘
大本钟敲=大本鐘敲
大历史=大歷史
大呆=大獃
大病初愈=大病初癒
大目干连=大目乾連
大笨钟=大笨鐘
大笨钟敲=大笨鐘敲
大蜡=大蜡
大衍历=大衍曆
大衍历史=大衍歷史
大言非夸=大言非夸
大赞=大讚
大周折=大週摺
大金发苔=大金髮苔
大锤=大鎚
大钟=大鐘
大只=大隻
大风后=大風後
大曲=大麴
天干物燥=天乾物燥
天克地冲=天克地衝
天后=天后
天后宫=天后宮
天地志狼=天地志狼
天地为范=天地為範
天干地支=天干地支
天后来=天後來
天后半=天後半
天后天=天後天
天文学家=天文學家
天文学钟=天文學鐘
天文历表=天文曆表
天文钟=天文鐘
天历=天曆
天历史=天歷史
天翻地覆=天翻地覆
天覆地载=天覆地載
太仆=太僕
太初历=太初曆
太初历史=太初歷史
太后=太后
夯干=夯幹
夸人=夸人
夸克=夸克
夸夸其谈=夸夸其談
夸姣=夸姣
夸容=夸容
夸毗=夸毗
夸父=夸父
夸特=夸特
夸脱=夸脫
夸诞=夸誕
夸诞不经=夸誕不經
夸丽=夸麗
奇迹=奇蹟
奇丑=奇醜
奏折=奏摺
奥占=奧佔
夺斗=奪鬥
奋斗=奮鬥
女丑=女丑
女佣人=女佣人
女佣=女傭
女仆=女僕
奴仆=奴僕
奸淫掳掠=奸淫擄掠
她克制=她剋制
好干=好乾
好家伙=好傢夥
好勇斗狠=好勇鬥狠
好斗大=好斗大
好斗室=好斗室
好斗笠=好斗笠
好斗篷=好斗篷
好斗胆=好斗膽
好斗膽=好斗膽
好斗蓬=好斗蓬
好于=好於
好呆=好獃
好困=好睏
好签=好籤
好丑=好醜
好斗=好鬥
如果干=如果幹
如饥似渴=如饑似渴
妖后=妖后
妙药=妙藥
始于=始於
委托=委託
委托书=委託書
姜文杰=姜文杰
奸夫=姦夫
奸妇=姦婦
奸宄=姦宄
奸情=姦情
奸杀=姦殺
奸污=姦汙
奸淫=姦淫
奸猾=姦猾
奸细=姦細
奸邪=姦邪
威棱=威稜
婢仆=婢僕
娲杆=媧杆
嫁祸于=嫁禍於
嫌凶=嫌兇
嫌好道丑=嫌好道醜
嬉游=嬉遊
嬖幸=嬖倖
嬴余=嬴餘
子之丰兮=子之丰兮
子云=子云
子晳=子晳
字汇=字彙
字码表=字碼表
字里行间=字裡行間
存十一于千百=存十一於千百
存折=存摺
存于=存於
孤寡不谷=孤寡不穀
学里=學裡
宇宙志=宇宙誌
安于=安於
安沈铁路=安瀋鐵路
安眠药=安眠藥
安胎药=安胎藥
宗周钟=宗周鐘
官不怕大只怕管=官不怕大只怕管
官地为采=官地為寀
官历=官曆
官历史=官歷史
官庄=官莊
定于=定於
定准=定準
定制=定製
宜云=宜云
宣泄=宣洩
宦游=宦遊
宫里=宮裡
害于=害於
宴游=宴遊
家仆=家僕
家具备=家具備
家具有=家具有
家具木工科=家具木工科
家具行=家具行
家具体=家具體
家庄=家莊
家里=家裡
家丑=家醜
容于=容於
容范=容範
宿舍=宿舍
寄托在=寄托在
寄托=寄託
密致=密緻
寇准=寇準
寇仇=寇讎
富余=富餘
寒假里=寒假裡
寒栗=寒慄
寒于=寒於
寓于=寓於
寡占=寡佔
寡欲=寡慾
实干=實幹
写字台=寫字檯
宽宽松松=寬寬鬆鬆
宽于=寬於
宽余=寬餘
宽松=寬鬆
寮采=寮寀
宝山庄=寶山庄
寶曆=寶曆
宝历=寶曆
宝历史=寶歷史
宝庄=寶莊
宝里宝气=寶裡寶氣
寸发千金=寸髮千金
寺钟=寺鐘
封后=封后
封面里=封面裡
射雕=射鵰
将占=將佔
将占卜=將占卜
专向往=專向往
专注=專註
专辑里=專輯裡
尊后=尊后
对折=對摺
对于=對於
对准=對準
对准表=對準錶
对准钟=對準鐘
对准钟表=對準鐘錶
对华发动=對華發動
对表中=對表中
对表扬=對表揚
对表明=對表明
对表格=對表格
对表演=對表演
对表现=對表現
对表示=對表示
对表达=對表達
对表=對錶
导游=導遊
小丑=小丑
小价=小价
小仆=小僕
小几=小几
小只可=小只可
小只在=小只在
小只是=小只是
小只会=小只會
小只有=小只有
小只能=小只能
小只需=小只需
小周后=小周后
小型钟=小型鐘
小型钟表面=小型鐘表面
小型钟表=小型鐘錶
小型钟面=小型鐘面
小伙子=小夥子
小米面=小米麵
小只=小隻
少占=少佔
少采=少採
就克制=就剋制
就范=就範
就里=就裡
尸位素餐=尸位素餐
尸利=尸利
尸居余气=尸居餘氣
尸弃佛=尸棄佛
尸祝=尸祝
尸禄=尸祿
尸罗精舍=尸羅精舍
尸羅精舍=尸羅精舍
尸臣=尸臣
尸谏=尸諫
尸魂界=尸魂界
尸鸠=尸鳩
局里=局裡
屁股大吊了心=屁股大弔了心
屋子里=屋子裡
屋梁=屋樑
屋里=屋裡
屏风后=屏風後
屑于=屑於
屡顾尔仆=屢顧爾僕
属于=屬於
属托=屬託
屯扎=屯紮
屯里=屯裡
山崩钟应=山崩鐘應
山岳=山嶽
山梁=山樑
山洞里=山洞裡
山棱=山稜
山羊胡=山羊鬍
山庄=山莊
山药=山藥
山里=山裡
山谷道=山谷道
山重水复=山重水複
岱岳=岱嶽
峰回=峰迴
峻岭=峻岭
昆剧=崑劇
昆山=崑山
昆仑=崑崙
昆仑山脉=崑崙山脈
昆曲=崑曲
昆腔=崑腔
昆苏=崑蘇
昆调=崑調
崖广=崖广
仑背=崙背
嶒棱=嶒稜
岳岳=嶽嶽
岳麓=嶽麓
川谷=川穀
巡回医疗=巡回醫療
巡回=巡迴
巡游=巡遊
工致=工緻
左冲右突=左衝右突
巧妇做不得无面馎饦=巧婦做不得無麵餺飥
巧干=巧幹
巧历=巧曆
巧历史=巧歷史
差之毫厘=差之毫厘
差之毫厘，谬以千里=差之毫釐，謬以千里
差于=差於
己丑=己丑
已占=已佔
已占卜=已占卜
已占算=已占算
巴尔干=巴爾幹
巷里=巷裡
市占=市佔
市占率=市佔率
市里=市裡
布谷=布穀
布谷鸟钟=布穀鳥鐘
布庄=布莊
布谷鸟=布谷鳥
希伯来历=希伯來曆
希伯来历史=希伯來歷史
帘子=帘子
帘布=帘布
帝后台=帝后臺
师范=師範
席卷=席捲
带团参加=帶團參加
带征=帶徵
带发修行=帶髮修行
帮佣=幫傭
干系=干係
干着急=干著急
平平当当=平平當當
平泉庄=平泉莊
平准=平準
年代里=年代裡
年历=年曆
年历史=年歷史
年谷=年穀
年里=年裡
并力=并力
并吞=并吞
并州=并州
并日而食=并日而食
并迭=并迭
幸免于难=幸免於難
幸于=幸於
幸运胡=幸運鬍
干上=幹上
干下去=幹下去
干不了=幹不了
干不成=幹不成
干了=幹了
干事=幹事
干些=幹些
干人=幹人
干什么=幹什麼
干个=幹個
干劲=幹勁
干劲冲天=幹勁沖天
干吏=幹吏
干员=幹員
干啥=幹啥
干吗=幹嗎
干嘛=幹嘛
干坏事=幹壞事
干完=幹完
干家=幹家
干将=幹將
干得=幹得
干性油=幹性油
干才=幹才
干掉=幹掉
干探=幹探
干校=幹校
干活=幹活
干流=幹流
干济=幹濟
干营生=幹營生
干父之蛊=幹父之蠱
干球温度=幹球溫度
干甚么=幹甚麼
干略=幹略
干当=幹當
干的停当=幹的停當
干细胞=幹細胞
干細胞=幹細胞
干线=幹線
干练=幹練
干缺=幹缺
干群关系=幹群關係
干蛊=幹蠱
干警=幹警
干起来=幹起來
干路=幹路
干办=幹辦
干这一行=幹這一行
干这种事=幹這種事
干道=幹道
干部=幹部
干革命=幹革命
干头=幹頭
干么=幹麼
几个=幾個
几周后=幾周後
几天后=幾天後
几只=幾隻
几出=幾齣
广部=广部
庄稼人=庄稼人
庄稼院=庄稼院
店里=店裡
府干卿=府干卿
府干擾=府干擾
府干扰=府干擾
府干政=府干政
府干涉=府干涉
府干犯=府干犯
府干預=府干預
府干预=府干預
府干=府幹
座钟=座鐘
康庄大道=康庄大道
康庄=康莊
厨余=廚餘
厮斗=廝鬥
庙里=廟裡
废后=廢后
廢后=廢后
广征=廣徵
广舍=廣捨
延历=延曆
建于=建於
弄干=弄乾
弄丑=弄醜
弄脏=弄髒
弄松=弄鬆
弄鬼吊猴=弄鬼弔猴
吊儿郎当=弔兒郎當
吊卷=弔卷
吊取=弔取
吊古=弔古
吊古寻幽=弔古尋幽
吊唁=弔唁
吊问=弔問
吊喉=弔喉
吊丧=弔喪
吊丧问疾=弔喪問疾
吊喭=弔喭
吊场=弔場
吊奠=弔奠
吊孝=弔孝
吊客=弔客
吊宴=弔宴
吊带=弔帶
吊影=弔影
吊慰=弔慰
吊扣=弔扣
吊拷=弔拷
吊拷绷扒=弔拷繃扒
吊挂=弔掛
吊撒=弔撒
吊文=弔文
吊旗=弔旗
吊书=弔書
吊桥=弔橋
吊死=弔死
吊死问孤=弔死問孤
吊死问疾=弔死問疾
吊民=弔民
吊民伐罪=弔民伐罪
吊祭=弔祭
吊纸=弔紙
吊者大悦=弔者大悅
吊腰撒跨=弔腰撒跨
吊脚儿事=弔腳兒事
吊膀子=弔膀子
吊词=弔詞
吊诡=弔詭
吊诡矜奇=弔詭矜奇
吊谎=弔謊
吊贺迎送=弔賀迎送
吊头=弔頭
吊颈=弔頸
吊鹤=弔鶴
引斗=引鬥
弘历=弘曆
弘历史=弘歷史
弱于=弱於
弱水三千只取一瓢=弱水三千只取一瓢
张三丰=張三丰
張三丰=張三丰
张勋=張勳
张乐于张徐=張樂于張徐
强占=強佔
强制作用=強制作用
强奸=強姦
强干=強幹
强于=強於
别口气=彆口氣
别强=彆強
别扭=彆扭
别拗=彆拗
别气=彆氣
弹子台=彈子檯
弹珠台=彈珠檯
弹药=彈藥
汇刊=彙刊
汇报=彙報
汇整=彙整
汇算=彙算
汇编=彙編
汇纂=彙纂
汇辑=彙輯
汇集=彙集
形单影只=形單影隻
形影相吊=形影相弔
形于=形於
彭于晏=彭于晏
影后=影后
仿佛=彷彿
役于=役於
彼此克制=彼此剋制
往日無仇=往日無讎
往里=往裡
往复=往複
待复=待覆
很干=很乾
很凶=很兇
很丑=很醜
律历志=律曆志
后印=後印
后台老板=後台老板
后天=後天
后庄=後庄
后面店=後面店
徐干=徐幹
徒托空言=徒託空言
得克制=得剋制
从于=從於
从里到外=從裡到外
从里向外=從裡向外
复始=復始
复活节历表=復活節曆表
征人=徵人
征令=徵令
征占=徵佔
征信=徵信
征候=徵候
征兆=徵兆
征兵=徵兵
征到=徵到
征募=徵募
征友=徵友
征召=徵召
征名责实=徵名責實
征吏=徵吏
征咎=徵咎
征启=徵啟
征士=徵士
征婚=徵婚
征实=徵實
征庸=徵庸
征引=徵引
征得=徵得
征怪=徵怪
征才=徵才
征招=徵招
征收=徵收
征效=徵效
征文=徵文
征求=徵求
征状=徵狀
征用=徵用
征发=徵發
征税=徵稅
征稿=徵稿
征答=徵答
征结=徵結
征圣=徵聖
征聘=徵聘
征训=徵訓
征询=徵詢
征调=徵調
征象=徵象
征购=徵購
征迹=徵跡
征车=徵車
征辟=徵辟
征逐=徵逐
征选=徵選
征集=徵集
征风召雨=徵風召雨
征验=徵驗
德占=德佔
心愿=心愿
心于=心於
心理=心理
心细如发=心細如髮
心系一=心繫一
心系世=心繫世
心系中=心繫中
心系乔=心繫乔
心系五=心繫五
心系京=心繫京
心系人=心繫人
心系他=心繫他
心系伊=心繫伊
心系何=心繫何
心系你=心繫你
心系健=心繫健
心系传=心繫傳
心系全=心繫全
心系两=心繫兩
心系农=心繫农
心系功=心繫功
心系动=心繫動
心系募=心繫募
心系北=心繫北
心系十=心繫十
心系千=心繫千
心系南=心繫南
心系台=心繫台
心系和=心繫和
心系哪=心繫哪
心系唐=心繫唐
心系嘱=心繫囑
心系四=心繫四
心系困=心繫困
心系国=心繫國
心系在=心繫在
心系地=心繫地
心系大=心繫大
心系天=心繫天
心系夫=心繫夫
心系奥=心繫奧
心系女=心繫女
心系她=心繫她
心系妻=心繫妻
心系妇=心繫婦
心系子=心繫子
心系它=心繫它
心系宣=心繫宣
心系家=心繫家
心系富=心繫富
心系小=心繫小
心系山=心繫山
心系川=心繫川
心系幼=心繫幼
心系广=心繫廣
心系彼=心繫彼
心系德=心繫德
心系您=心繫您
心系慈=心繫慈
心系我=心繫我
心系摩=心繫摩
心系故=心繫故
心系新=心繫新
心系日=心繫日
心系昌=心繫昌
心系晓=心繫曉
心系曼=心繫曼
心系东=心繫東
心系林=心繫林
心系母=心繫母
心系民=心繫民
心系江=心繫江
心系汶=心繫汶
心系沈=心繫沈
心系沙=心繫沙
心系泰=心繫泰
心系浙=心繫浙
心系港=心繫港
心系湖=心繫湖
心系澳=心繫澳
心系灾=心繫災
心系父=心繫父
心系生=心繫生
心系病=心繫病
心系百=心繫百
心系的=心繫的
心系众=心繫眾
心系社=心繫社
心系祖=心繫祖
心系神=心繫神
心系红=心繫紅
心系美=心繫美
心系群=心繫群
心系老=心繫老
心系舞=心繫舞
心系英=心繫英
心系茶=心繫茶
心系万=心繫萬
心系着=心繫著
心系兰=心繫蘭
心系西=心繫西
心系贫=心繫貧
心系输=心繫輸
心系近=心繫近
心系远=心繫遠
心系选=心繫選
心系重=心繫重
心系长=心繫長
心系阮=心繫阮
心系震=心繫震
心系非=心繫非
心系风=心繫風
心系香=心繫香
心系高=心繫高
心系麦=心繫麥
心系黄=心繫黃
心脏=心臟
心荡=心蕩
心药=心藥
心里面=心裏面
心里=心裡
心长发短=心長髮短
心余=心餘
必须=必須
忙并=忙併
忙里=忙裡
忙里偷闲=忙裡偷閒
忠人之托=忠人之托
忠仆=忠僕
忠于=忠於
快干=快乾
快克制=快剋制
快快当当=快快當當
快冲=快衝
怎么=怎麼
怎么着=怎麼著
怒于=怒於
怒发冲冠=怒髮衝冠
思如泉涌=思如泉湧
怠于=怠於
急于=急於
急冲而下=急衝而下
性征=性徵
性欲=性慾
怪里怪气=怪裡怪氣
怫郁=怫鬱
恂栗=恂慄
恒生=恒生
恕乏价催=恕乏价催
息交绝游=息交絕遊
息谷=息穀
恰才=恰纔
悍药=悍藥
悒郁=悒鬱
悠悠荡荡=悠悠蕩蕩
悠荡=悠蕩
悠游=悠遊
您克制=您剋制
悲筑=悲筑
悲郁=悲鬱
闷着头儿干=悶著頭兒幹
悸栗=悸慄
情欲=情慾
惇朴=惇樸
恶直丑正=惡直醜正
恶斗=惡鬥
想克制=想剋制
惴栗=惴慄
意占=意佔
意克制=意剋制
意大利面=意大利麵
意面=意麵
爱困=愛睏
感冒药=感冒藥
感于=感於
愿朴=愿樸
愿而恭=愿而恭
栗冽=慄冽
栗栗=慄慄
慌里慌张=慌裡慌張
庆吊=慶弔
庆历=慶曆
庆历史=慶歷史
欲令智昏=慾令智昏
欲壑难填=慾壑難填
欲念=慾念
欲望=慾望
欲海=慾海
欲火=慾火
欲障=慾障
忧郁=憂鬱
凭几=憑几
凭吊=憑弔
凭折=憑摺
凭准=憑準
凭借=憑藉
凭借着=憑藉著
恳托=懇託
懈松=懈鬆
应克制=應剋制
应征=應徵
应钟=應鐘
懔栗=懍慄
蒙懂=懞懂
蒙蒙懂懂=懞懞懂懂
蒙直=懞直
惩忿窒欲=懲忿窒欲
怀里=懷裡
怀表=懷錶
怀钟=懷鐘
悬挂=懸掛
悬梁=懸樑
悬臂梁=懸臂樑
悬钟=懸鐘
懿范=懿範
恋恋不舍=戀戀不捨
成于=成於
成于思=成於思
成药=成藥
我克制=我剋制
戬谷=戩穀
截发=截髮
战天斗地=戰天鬥地
战栗=戰慄
战斗=戰鬥
戏彩娱亲=戲綵娛親
戏里=戲裡
戴表元=戴表元
戴表=戴錶
戴发含齿=戴髮含齒
房里=房裡
所云=所云
所云云=所云云
所占=所佔
所占卜=所占卜
所占星=所占星
所占算=所占算
所托=所託
扁拟谷盗虫=扁擬穀盜蟲
手塚治虫=手塚治虫
手冢治虫=手塚治虫
手折=手摺
手表态=手表態
手表明=手表明
手表决=手表決
手表演=手表演
手表现=手表現
手表示=手表示
手表达=手表達
手表露=手表露
手表面=手表面
手里剑=手裏劍
手里=手裡
手表=手錶
手松=手鬆
才克制=才剋制
才干休=才干休
才干戈=才干戈
才干扰=才干擾
才干政=才干政
才干涉=才干涉
才干预=才干預
才干=才幹
扎好底子=扎好底子
扎好根=扎好根
扑作教刑=扑作教刑
扑打=扑打
扑挞=扑撻
打干哕=打乾噦
打并=打併
打出吊入=打出弔入
打卡钟=打卡鐘
打吨=打吨
打干=打幹
打拼=打拚
打断发=打斷發
打谷=打穀
打着钟=打著鐘
打路庄板=打路莊板
打钟=打鐘
打风后=打風後
打斗=打鬥
托管国=托管國
扛大梁=扛大樑
扞御=扞禦
扯面=扯麵
扶余国=扶餘國
批准的=批准的
批复=批覆
批注=批註
批斗=批鬥
承制=承製
抑制作用=抑制作用
抑制剂=抑制劑
抑郁=抑鬱
抓奸=抓姦
抓药=抓藥
抓斗=抓鬥
投药=投藥
抗癌药=抗癌藥
抗御=抗禦
抗药=抗藥
折向往=折向往
折子戏=折子戲
折戟沈河=折戟沈河
折冲=折衝
披榛采兰=披榛採蘭
披头散发=披頭散髮
披发=披髮
抱朴而长吟兮=抱朴而長吟兮
抱素怀朴=抱素懷樸
抵御=抵禦
抹干=抹乾
抽公签=抽公籤
抽签=抽籤
抿发=抿髮
拂钟无声=拂鐘無聲
拆伙=拆夥
拈须=拈鬚
拉克施尔德钟=拉克施爾德鐘
拉杆=拉杆
拉纤=拉縴
拉面上=拉面上
拉面具=拉面具
拉面前=拉面前
拉面巾=拉面巾
拉面无=拉面無
拉面皮=拉面皮
拉面罩=拉面罩
拉面色=拉面色
拉面部=拉面部
拉面=拉麵
拒人于=拒人於
拒于=拒於
拓朴=拓樸
拔发=拔髮
拔须=拔鬚
拗别=拗彆
拘于=拘於
拙于=拙於
拙朴=拙樸
拼却=拚卻
拼命=拚命
拼舍=拚捨
拼死=拚死
拼生尽死=拚生盡死
拼绝=拚絕
拼老命=拚老命
拼斗=拚鬥
拜托=拜託
括发=括髮
拭干=拭乾
拮据=拮据
拼死拼活=拼死拼活
拾沈=拾瀋
拿下表=拿下錶
拿下钟=拿下鐘
拿准=拿準
拿破仑=拿破崙
挂图=挂圖
挂帅=挂帥
挂彩=挂彩
挂念=挂念
挂号=挂號
挂车=挂車
挂面=挂面
挌斗=挌鬥
挑大梁=挑大樑
挑斗=挑鬥
振荡=振蕩
捆扎=捆紮
捉奸徒=捉奸徒
捉奸细=捉奸細
捉奸贼=捉奸賊
捉奸党=捉奸黨
捉奸=捉姦
捉发=捉髮
捍御=捍禦
捏面人=捏麵人
舍不得=捨不得
舍出=捨出
舍去=捨去
舍命=捨命
舍堕=捨墮
舍安就危=捨安就危
舍实=捨實
舍己从人=捨己從人
舍己救人=捨己救人
舍己为人=捨己為人
舍己为公=捨己為公
舍己为国=捨己為國
舍得=捨得
舍我其谁=捨我其誰
舍本逐末=捨本逐末
舍弃=捨棄
舍死忘生=捨死忘生
舍生=捨生
舍短取长=捨短取長
舍身=捨身
舍车保帅=捨車保帥
舍近求远=捨近求遠
卷住=捲住
卷来=捲來
卷儿=捲兒
卷入=捲入
卷动=捲動
卷去=捲去
卷图=捲圖
卷土重来=捲土重來
卷尺=捲尺
卷心菜=捲心菜
卷成=捲成
卷曲=捲曲
卷款=捲款
卷毛=捲毛
卷烟=捲煙
卷筒=捲筒
卷帘=捲簾
卷纸=捲紙
卷缩=捲縮
卷舌=捲舌
卷舖盖=捲舖蓋
卷菸=捲菸
卷袖=捲袖
卷走=捲走
卷起=捲起
卷轴=捲軸
卷逃=捲逃
卷铺盖=捲鋪蓋
卷云=捲雲
卷风=捲風
卷发=捲髮
捵面=捵麵
捶炼=捶鍊
扫荡=掃蕩
掌柜=掌柜
排骨面=排骨麵
挂名=掛名
挂帘=掛帘
挂历=掛曆
挂钩=掛鈎
挂钟=掛鐘
采下=採下
采伐=採伐
采住=採住
采信=採信
采光=採光
采到=採到
采制=採制
采区=採區
采去=採去
采取=採取
采回=採回
采在=採在
采好=採好
采得=採得
采拾=採拾
采挖=採挖
采掘=採掘
采摘=採摘
采摭=採摭
采择=採擇
采撷=採擷
采收=採收
采料=採料
采暖=採暖
采桑=採桑
采样=採樣
采樵人=採樵人
采树种=採樹種
采气=採氣
采油=採油
采为=採為
采煤=採煤
采获=採獲
采猎=採獵
采珠=採珠
采生折割=採生折割
采用=採用
采的=採的
采石=採石
采砂场=採砂場
采矿=採礦
采种=採種
采空区=採空區
采空采穗=採空採穗
采納=採納
采纳=採納
采给=採給
采花=採花
采芹人=採芹人
采茶=採茶
采菊=採菊
采莲=採蓮
采薇=採薇
采薪=採薪
采药=採藥
采行=採行
采补=採補
采访=採訪
采证=採證
采买=採買
采购=採購
采办=採辦
采运=採運
采过=採過
采选=採選
采金=採金
采录=採錄
采铁=採鐵
采集=採集
采风=採風
采风问俗=採風問俗
采食=採食
采盐=採鹽
掣签=掣籤
接着说=接著說
控制=控制
推情准理=推情準理
推托之词=推托之詞
推舟于陆=推舟於陸
推托=推託
提子干=提子乾
提心吊胆=提心弔膽
提摩太后书=提摩太後書
插于=插於
换签=換籤
换药=換藥
换只=換隻
换发=換髮
握发=握髮
揩干=揩乾
揪采=揪採
揪发=揪髮
揪须=揪鬚
揭丑=揭醜
挥手表=揮手表
挥杆=揮杆
搋面=搋麵
损于=損於
搏斗=搏鬥
摇摇荡荡=搖搖蕩蕩
摇荡=搖蕩
捣鬼吊白=搗鬼弔白
搤肮拊背=搤肮拊背
搬斗=搬鬥
搭干铺=搭乾鋪
搭伙=搭夥
抢占=搶佔
搽药=搽藥
摧坚获丑=摧堅獲醜
摭采=摭採
摸棱=摸稜
摸钟=摸鐘
折合=摺合
折奏=摺奏
折子=摺子
折尺=摺尺
折扇=摺扇
折梯=摺梯
折椅=摺椅
折叠=摺疊
折痕=摺痕
折篷=摺篷
折纸=摺紙
折裙=摺裙
撇吊=撇弔
捞干=撈乾
捞面=撈麵
撚须=撚鬚
撞球台=撞球檯
撞钟=撞鐘
撞阵冲军=撞陣衝軍
撤并=撤併
拨谷=撥穀
撩斗=撩鬥
播于=播於
扑冬=撲鼕
扑冬冬=撲鼕鼕
擀面=擀麵
击扑=擊扑
击钟=擊鐘
操作钟=操作鐘
担仔面=擔仔麵
担担面=擔擔麵
担着=擔著
担负着=擔負著
据云=據云
据干而窥井底=據榦而窺井底
擢发=擢髮
擦干=擦乾
擦干净=擦乾淨
擦药=擦藥
拧干=擰乾
摆钟=擺鐘
摄制=攝製
支干=支幹
支杆=支杆
收获=收穫
改征=改徵
攻占=攻佔
放蒙挣=放懞掙
放荡=放蕩
放松=放鬆
故事里=故事裡
故云=故云
敏于=敏於
救药=救藥
败于=敗於
叙说着=敘說著
教学钟=教學鐘
教于=教於
教范=教範
敢干=敢幹
敢情欲=敢情欲
敢斗了胆=敢斗了膽
散伙=散夥
散于=散於
散荡=散蕩
敦朴=敦樸
敬挽=敬輓
敲扑=敲扑
敲钟=敲鐘
整庄=整莊
整只=整隻
整风后=整風後
整发用品=整髮用品
敌忾同仇=敵愾同讎
敷药=敷藥
数天后=數天後
数字钟=數字鐘
数字钟表=數字鐘錶
数学家=數學家
数罪并罚=數罪併罰
数与虏确=數與虜确
文丑=文丑
文汇报=文匯報
文征明=文徵明
文思泉涌=文思泉湧
文采郁郁=文采郁郁
斗转参横=斗轉參橫
斫雕为朴=斫雕為樸
新井里美=新井里美
新历=新曆
新历史=新歷史
新扎=新紮
新庄=新莊
新庄市=新莊市
斲雕为朴=斲雕為樸
断发=斷髮
断发文身=斷髮文身
方便面=方便麵
方几=方几
方向往=方向往
方志=方誌
方面=方面
于0=於0
于1=於1
于2=於2
于3=於3
于4=於4
于5=於5
于6=於6
于7=於7
于8=於8
于9=於9
于一=於一
于一役=於一役
于七=於七
于三=於三
于世=於世
于之=於之
于乎=於乎
于九=於九
于事=於事
于二=於二
于五=於五
于人=於人
于今=於今
于他=於他
于伏=於伏
于何=於何
于你=於你
于八=於八
于六=於六
于克制=於剋制
于前=於前
于劣=於劣
于勤=於勤
于十=於十
于半=於半
于呼哀哉=於呼哀哉
于四=於四
于国=於國
于坏=於坏
于垂=於垂
于夫罗=於夫羅
於夫罗=於夫羅
於夫羅=於夫羅
于她=於她
于好=於好
于始=於始
於姓=於姓
于它=於它
于家=於家
于密=於密
于差=於差
于己=於己
于市=於市
于幕=於幕
于弱=於弱
于强=於強
于后=於後
于征=於徵
于心=於心
于怀=於懷
于我=於我
于戏=於戲
于敝=於敝
于斯=於斯
于是=於是
于是乎=於是乎
于时=於時
于梨华=於梨華
於梨華=於梨華
于乐=於樂
于此=於此
於氏=於氏
于民=於民
于水=於水
于法=於法
于海上=於海上
于海边=於海邊
于潜县=於潛縣
于火=於火
于焉=於焉
于墙=於牆
于物=於物
于毕=於畢
于尽=於盡
于盲=於盲
于祂=於祂
于穆=於穆
于终=於終
于美=於美
于色=於色
于菟=於菟
于蓝=於藍
于行=於行
于衷=於衷
于该=於該
于农=於農
于途=於途
于过=於過
于邑=於邑
于丑=於醜
于野=於野
于陆=於陸
于震中=於震中
于震前=於震前
于震后=於震后
于０=於０
于１=於１
于２=於２
于３=於３
于４=於４
于５=於５
于６=於６
于７=於７
于８=於８
于９=於９
施舍=施捨
施于=施於
施舍之道=施舍之道
施药=施藥
旁征博引=旁徵博引
旁注=旁註
旅游=旅遊
旋干转坤=旋乾轉坤
旋绕着=旋繞著
旋回=旋迴
族里=族裡
旗杆=旗杆
日占=日佔
日子里=日子裡
日心历表=日心曆表
日晒=日晒
日历=日曆
日历史=日歷史
日志=日誌
早于=早於
旱干=旱乾
昆仑山=昆崙山
升平=昇平
升阳=昇陽
昊天不吊=昊天不弔
明天=明天
明征=明徵
明目张胆=明目張胆
明窗净几=明窗淨几
明范=明範
明里=明裡
易克制=易剋制
易于=易於
星巴克=星巴克
星历=星曆
星期后=星期後
星历史=星歷史
星辰表=星辰錶
春假里=春假裡
春天里=春天裡
春日里=春日裡
春药=春藥
春游=春遊
春香斗学=春香鬥學
昨天=昨天
时钟=時鐘
时间里=時間裡
晃荡=晃蕩
晋升=晉陞
晒干=晒乾
晒伤=晒傷
晒图=晒圖
晒图纸=晒圖紙
晒成=晒成
晒晒=晒晒
晒烟=晒煙
晒种=晒種
晒衣=晒衣
晒黑=晒黑
晚于=晚於
晚钟=晚鐘
晞发=晞髮
晨钟=晨鐘
普冬冬=普鼕鼕
景致=景緻
晾干=晾乾
晕船药=暈船藥
晕车药=暈車藥
暑假里=暑假裡
暗地里=暗地裡
暗沟里=暗溝裡
暗里=暗裡
暗斗=暗鬥
畅游=暢遊
暴敛横征=暴斂橫徵
暴晒=暴晒
历元=曆元
历命=曆命
历始=曆始
历室=曆室
历尾=曆尾
历数=曆數
历日=曆日
历书=曆書
历本=曆本
历法=曆法
历狱=曆獄
历纪=曆紀
历象=曆象
曝晒=曝晒
晒谷=曬穀
曰云=曰云
更仆难数=更僕難數
更签=更籤
更钟=更鐘
书呆子=書獃子
书签=書籤
书面=書面
曼谷人=曼谷人
曾朴=曾樸
最多=最多
会上签署=會上簽署
会上签订=會上簽訂
会占=會佔
会占卜=會占卜
会干扰=會干擾
會干擾=會干擾
会干=會幹
会吊=會弔
会里=會裡
月历=月曆
月历史=月歷史
月球历表=月球曆表
月离于毕=月離於畢
月面=月面
月丽于箕=月麗於箕
有事之无范=有事之無範
有仆=有僕
有只不=有只不
有只允=有只允
有只容=有只容
有只採=有只採
有只采=有只採
有只是=有只是
有只用=有只用
有够赞=有夠讚
有征伐=有征伐
有征戰=有征戰
有征战=有征戰
有征服=有征服
有征讨=有征討
有征討=有征討
有征=有徵
有恒街=有恒街
有栖川=有栖川
有准=有準
有棱有角=有稜有角
有只=有隻
有余=有餘
有发头陀寺=有髮頭陀寺
服于=服於
服药=服藥
望了望=望了望
望后石=望后石
望着表=望著錶
望着钟=望著鐘
望着钟表=望著鐘錶
朝乾夕惕=朝乾夕惕
朝钟=朝鐘
朦胧=朦朧
蒙胧=朦朧
木偶戏扎=木偶戲紮
木杆=木杆
木材干馏=木材乾餾
木梁=木樑
木制=木製
木钟=木鐘
未干=未乾
未干涉=未干涉
末药=末藥
本征=本徵
术赤=朮赤
朱仑街=朱崙街
朱庆余=朱慶餘
朱理安历=朱理安曆
朱理安历史=朱理安歷史
杆子=杆子
李志喜=李志喜
李連杰=李連杰
李连杰=李連杰
材干=材幹
村子里=村子裡
村庄=村莊
村落发=村落發
村里=村裡
村里长=村里長
村里長=村里長
杜老志道=杜老誌道
杞宋无征=杞宋無徵
束发=束髮
杯干=杯乾
杯面=杯麵
杰伦=杰倫
杰威爾音樂=杰威爾音樂
杰威尔音乐=杰威爾音樂
杰特=杰特
东周钟=東周鐘
东岳=東嶽
东冲西突=東衝西突
东游=東遊
松山庄=松山庄
板着脸=板著臉
板荡=板蕩
林宏岳=林宏嶽
林郁方=林郁方
林钟=林鐘
果干=果乾
果子干=果子乾
枝不得大于干=枝不得大於榦
枝干=枝幹
枯干=枯乾
台历=枱曆
架钟=架鐘
某只=某隻
染指于=染指於
染殿后=染殿后
染发=染髮
柜上=柜上
柜子=柜子
柜柳=柜柳
柱梁=柱樑
柳诒征=柳詒徵
栖栖皇皇=栖栖皇皇
校准=校準
校仇=校讎
核准的=核准的
格于=格於
格范=格範
格里历=格里曆
格里高利历=格里高利曆
格斗=格鬥
桂圆干=桂圓乾
桅杆=桅杆
桌几=桌几
桌历=桌曆
桌历史=桌歷史
桑干=桑乾
梁上君子=梁上君子
条干=條幹
梨干=梨乾
梯冲=梯衝
械系=械繫
械斗=械鬥
弃舍=棄捨
棉制=棉製
棒子面=棒子麵
枣庄=棗莊
栋梁=棟樑
棫朴=棫樸
森林里=森林裡
棺材里=棺材裡
植发=植髮
椰枣干=椰棗乾
楊雅筑=楊雅筑
杨雅筑=楊雅筑
楚庄问鼎=楚莊問鼎
楚庄王=楚莊王
楚庄绝缨=楚莊絕纓
桢干=楨幹
业余=業餘
榨干=榨乾
杠杆=槓桿
乐器钟=樂器鐘
樊于期=樊於期
梁上=樑上
梁柱=樑柱
樗里子=樗里子
标杆=標杆
标标致致=標標致致
标准=標準
标签=標籤
标致=標緻
标注=標註
标志=標誌
模棱=模稜
模范=模範
模范14棒=模范14棒
模范21棒=模范21棒
模范七棒=模范七棒
模范三军=模范三軍
模范三軍=模范三軍
模范棒棒堂=模范棒棒堂
模制=模製
样范=樣範
樵采=樵採
朴修斯=樸修斯
朴厚=樸厚
朴学=樸學
朴实=樸實
朴念仁=樸念仁
朴拙=樸拙
朴樕=樸樕
朴父=樸父
朴直=樸直
朴素=樸素
朴讷=樸訥
朴质=樸質
朴鄙=樸鄙
朴重=樸重
朴野=樸野
朴钝=樸鈍
朴陋=樸陋
朴马=樸馬
朴鲁=樸魯
树干=樹榦
树梁=樹樑
桥梁=橋樑
機械系=機械系
机械系=機械系
机械表=機械錶
机械钟=機械鐘
机械钟表=機械鐘錶
机绣=機繡
横征暴敛=橫徵暴斂
横杆=橫杆
横梁=橫樑
横冲=橫衝
台子=檯子
台布=檯布
台灯=檯燈
台球=檯球
台面=檯面
柜台=櫃檯
栉发工=櫛髮工
栏杆=欄杆
欲海难填=欲海難填
欺蒙=欺矇
歌后=歌后
歌钟=歌鐘
欧游=歐遊
止咳药=止咳藥
止于=止於
止痛药=止痛藥
止血药=止血藥
正在叱咤=正在叱咤
正官庄=正官庄
正当着=正當著
武丑=武丑
武后=武后
武斗=武鬥
岁聿云暮=歲聿云暮
历史里=歷史裡
归并=歸併
归于=歸於
归余=歸餘
歹斗=歹鬥
死于=死於
死里求生=死裡求生
死里逃生=死裡逃生
殖谷=殖穀
残肴=殘肴
残余=殘餘
僵尸=殭屍
殷师牛斗=殷師牛鬥
杀虫药=殺蟲藥
壳里=殼裡
殿钟自鸣=殿鐘自鳴
毁于=毀於
毁钟为铎=毀鐘為鐸
殴斗=毆鬥
母后=母后
母范=母範
母丑=母醜
每每只=每每只
每只=每隻
毒药=毒藥
毗婆尸佛=毗婆尸佛
毛坏=毛坏
毛姜=毛薑
毛发=毛髮
毫厘=毫釐
毫发=毫髮
气冲斗牛=氣沖斗牛
气郁=氣鬱
氤郁=氤鬱
水来汤里去=水來湯裡去
水准=水準
水无怜奈=水無怜奈
水里=水裡
水里溪=水里溪
水里浊水溪=水里濁水溪
水里鄉=水里鄉
水里乡=水里鄉
永历=永曆
永历史=永歷史
永志不忘=永誌不忘
求知欲=求知慾
求签=求籤
求道于盲=求道於盲
池里=池裡
污蔑=污衊
汲于=汲於
决斗=決鬥
沈淀=沈澱
沈着=沈著
沈郁=沈鬱
沉淀=沉澱
沉郁=沉鬱
没干没净=沒乾沒淨
没事干=沒事幹
没干=沒幹
没折至=沒摺至
没梢干=沒梢幹
没样范=沒樣範
没准=沒準
没药=沒藥
冲冠发怒=沖冠髮怒
沙里淘金=沙裡淘金
河岳=河嶽
河流汇集=河流匯集
河里=河裡
油斗=油鬥
油面=油麵
治愈=治癒
沿溯=沿泝
法占=法佔
法自制=法自制
泛游=泛遊
泡制=泡製
泡面=泡麵
波棱菜=波稜菜
波发藻=波髮藻
泥于=泥於
注云=注云
注释=注釋
泰山梁木=泰山梁木
泱郁=泱鬱
泳气钟=泳氣鐘
洄游=洄遊
洒家=洒家
洒扫=洒掃
洒水=洒水
洒洒=洒洒
洒淅=洒淅
洒涤=洒滌
洒濯=洒濯
洒然=洒然
洒脱=洒脫
洗炼=洗鍊
洗练=洗鍊
洗发=洗髮
洛钟东应=洛鐘東應
泄欲=洩慾
洪范=洪範
洪适=洪适
洪钟=洪鐘
汹涌=洶湧
派团参加=派團參加
流征=流徵
流于=流於
流荡=流蕩
流风余俗=流風餘俗
流风余韵=流風餘韻
浩浩荡荡=浩浩蕩蕩
浩荡=浩蕩
浪琴表=浪琴錶
浪荡=浪蕩
浪游=浪遊
浮于=浮於
浮荡=浮蕩
浮夸=浮誇
浮松=浮鬆
海上布雷=海上佈雷
海干=海乾
海湾布雷=海灣佈雷
涂善妮=涂善妮
涂坤=涂坤
涂壯勳=涂壯勳
涂壮勋=涂壯勳
涂天相=涂天相
涂姓=涂姓
涂序瑄=涂序瑄
涂敏恒=涂敏恆
涂敏恆=涂敏恆
涂澤民=涂澤民
涂泽民=涂澤民
涂绍煃=涂紹煃
涂羽卿=涂羽卿
涂謹申=涂謹申
涂谨申=涂謹申
涂逢年=涂逢年
涂醒哲=涂醒哲
涂長望=涂長望
涂长望=涂長望
涂鸿钦=涂鴻欽
涂鴻欽=涂鴻欽
消炎药=消炎藥
消肿药=消腫藥
液晶表=液晶錶
涳蒙=涳濛
涸干=涸乾
凉面=涼麵
淋余土=淋餘土
淑范=淑範
泪干=淚乾
泪如泉涌=淚如泉湧
淡于=淡於
淡蒙蒙=淡濛濛
淡朱=淡硃
净余=淨餘
净发=淨髮
淫欲=淫慾
淫荡=淫蕩
淬炼=淬鍊
深山何处钟=深山何處鐘
深渊里=深淵裡
淳于=淳于
淳朴=淳樸
渊淳岳峙=淵淳嶽峙
浅淀=淺澱
清心寡欲=清心寡欲
清汤挂面=清湯掛麵
减肥药=減肥藥
渠冲=渠衝
测试=測試
港制=港製
游离=游離
浑朴=渾樸
浑个=渾箇
凑合着=湊合著
湖里=湖裡
湘绣=湘繡
湘累=湘纍
湟潦生苹=湟潦生苹
涌上=湧上
涌来=湧來
涌入=湧入
涌出=湧出
涌向=湧向
涌泉=湧泉
涌现=湧現
涌起=湧起
涌进=湧進
湮郁=湮鬱
汤下面=湯下麵
汤团=湯糰
汤药=湯藥
汤面=湯麵
源于=源於
准不准=準不準
准例=準例
准保=準保
准备=準備
准儿=準兒
准分子=準分子
准则=準則
准噶尔=準噶爾
准定=準定
准平原=準平原
准度=準度
准式=準式
准拿督=準拿督
准据=準據
准拟=準擬
准新娘=準新娘
准新郎=準新郎
准星=準星
准是=準是
准时=準時
准会=準會
准决赛=準決賽
准的=準的
准直=準直
准确=準確
准线=準線
准绳=準繩
准话=準話
准谱=準譜
准货币=準貨幣
准头=準頭
准点=準點
溟蒙=溟濛
溢于=溢於
溲面=溲麵
溺于=溺於
滃郁=滃鬱
滑借=滑藉
汇丰=滙豐
卤味=滷味
卤水=滷水
卤汁=滷汁
卤湖=滷湖
卤肉=滷肉
卤菜=滷菜
卤蛋=滷蛋
卤制=滷製
卤鸡=滷雞
卤面=滷麵
满拼自尽=滿拚自盡
满满当当=滿滿當當
满头洋发=滿頭洋髮
漂荡=漂蕩
漕挽=漕輓
沤郁=漚鬱
汉弥登钟=漢彌登鐘
汉弥登钟表公司=漢彌登鐘錶公司
漫游=漫遊
潜意识里=潛意識裡
潜水表=潛水錶
潜水钟=潛水鐘
潜水钟表=潛水鐘錶
潭里=潭裡
潮涌=潮湧
溃于=潰於
涩谷区=澀谷區
澄澹精致=澄澹精致
澒蒙=澒濛
泽渗漓而下降=澤滲灕而下降
淀乃不耕之地=澱乃不耕之地
淀北片=澱北片
淀山=澱山
淀淀=澱澱
淀积=澱積
淀粉=澱粉
淀解物=澱解物
淀谓之滓=澱謂之滓
澹台=澹臺
澹荡=澹蕩
激荡=激蕩
浓发=濃髮
蒙汜=濛汜
蒙蒙细雨=濛濛細雨
蒙雾=濛霧
蒙松雨=濛鬆雨
蒙鸿=濛鴻
滨田里佳子=濱田里佳子
泻药=瀉藥
沈吉线=瀋吉線
沈山线=瀋山線
沈州=瀋州
沈水=瀋水
沈河=瀋河
沈海=瀋海
沈海铁路=瀋海鐵路
沈阳=瀋陽
潇洒=瀟洒
弥山遍野=瀰山遍野
弥漫=瀰漫
弥漫着=瀰漫著
弥弥=瀰瀰
灌药=灌藥
漓水=灕水
漓江=灕江
漓湘=灕湘
漓然=灕然
滩涂=灘涂
火并非=火並非
火并=火併
火拼=火拚
火折子=火摺子
火箭布雷=火箭佈雷
火签=火籤
火药=火藥
灰蒙=灰濛
灰蒙蒙=灰濛濛
炆面=炆麵
炒面=炒麵
炮制=炮製
炸药=炸藥
炸酱面=炸醬麵
为准=為準
为着=為著
乌发=烏髮
乌龙面=烏龍麵
烘干=烘乾
烘制=烘製
烤干=烤乾
烤晒=烤晒
焙干=焙乾
无征不信=無徵不信
无业游民=無業游民
无梁楼盖=無樑樓蓋
无法克制=無法剋制
无药可救=無藥可救
無言不仇=無言不讎
无余=無餘
然身死才数月耳=然身死纔數月耳
炼药=煉藥
炼制=煉製
煎药=煎藥
煎面=煎麵
烟卷=煙捲
烟斗丝=煙斗絲
照占=照佔
照入签=照入籤
照准=照準
照相干片=照相乾片
煨干=煨乾
煮面=煮麵
熊杰=熊杰
荧郁=熒鬱
熬药=熬藥
炖药=燉藥
燎发=燎髮
烧干=燒乾
燕几=燕几
燕巢于幕=燕巢於幕
燕燕于飞=燕燕于飛
燕游=燕遊
烫一个发=燙一個髮
烫一次发=燙一次髮
烫个发=燙個髮
烫完发=燙完髮
烫次发=燙次髮
烫发=燙髮
烫面=燙麵
营干=營幹
烬余=燼餘
爆发指数=爆發指數
争奇斗妍=爭奇鬥妍
争奇斗异=爭奇鬥異
争奇斗艳=爭奇鬥豔
争妍斗奇=爭妍鬥奇
争妍斗艳=爭妍鬥豔
争红斗紫=爭紅鬥紫
争斗=爭鬥
爰定祥历=爰定祥厤
爽荡=爽蕩
尔冬升=爾冬陞
墙里=牆裡
片言只语=片言隻語
牙签=牙籤
牛肉面=牛肉麵
牛只=牛隻
物欲=物慾
物理学家=物理學家
特别致=特别致
特制住=特制住
特制定=特制定
特制止=特制止
特制订=特制訂
特征=特徵
特效药=特效藥
特制=特製
牵一发=牽一髮
牵系=牽繫
荦确=犖确
狂占=狂佔
狂并潮=狂併潮
狃于=狃於
狄志杰=狄志杰
狐借虎威=狐藉虎威
猛于=猛於
猛冲=猛衝
猜三划五=猜三划五
犹如表=猶如錶
犹如钟=猶如鐘
犹如钟表=猶如鐘錶
呆串了皮=獃串了皮
呆事=獃事
呆人=獃人
呆子=獃子
呆性=獃性
呆想=獃想
呆憨呆=獃憨獃
呆根=獃根
呆气=獃氣
呆滞=獃滯
呆呆=獃獃
呆痴=獃痴
呆磕=獃磕
呆等=獃等
呆脑=獃腦
呆着=獃著
呆话=獃話
呆头=獃頭
狱里=獄裡
奖杯=獎盃
独占=獨佔
独占鳌头=獨佔鰲頭
独辟蹊径=獨闢蹊徑
获匪其丑=獲匪其醜
兽欲=獸慾
献丑=獻醜
率团参加=率團參加
玉历=玉曆
玉历史=玉歷史
王侯后=王侯后
王后=王后
王田里=王田里
王庄=王莊
王余鱼=王餘魚
珍肴异馔=珍肴異饌
班里=班裡
现于=現於
球杆=球杆
理一个发=理一個髮
理一次发=理一次髮
理个发=理個髮
理完发=理完髮
理次发=理次髮
理发=理髮
琴钟=琴鐘
瑞征=瑞徵
瑶签=瑤籤
环游=環遊
瓷制=瓷製
甄后=甄后
瓮安=甕安
甚于=甚於
甚么=甚麼
甜水面=甜水麵
甜面酱=甜麵醬
生力面=生力麵
生于=生於
生殖洄游=生殖洄游
生物学家=生物學家
生物钟=生物鐘
生发生=生發生
生华发=生華髮
生姜=生薑
生锈=生鏽
生发=生髮
产卵洄游=產卵洄游
用药=用藥
甩发=甩髮
田庄英雄=田庄英雄
田谷=田穀
田庄=田莊
田里=田裡
由余=由余
由于=由於
由表及里=由表及裡
甲后路=甲后路
男佣人=男佣人
男仆=男僕
男用表=男用錶
畏于=畏於
留发=留髮
毕于=畢於
毕业于=畢業於
毕生发展=畢生發展
画着=畫著
当家才知柴米价=當家纔知柴米價
当准=當準
当当丁丁=當當丁丁
当着=當著
疏松=疏鬆
疑系=疑係
疑凶=疑兇
疲于=疲於
疲困=疲睏
病征=病徵
病愈=病癒
病余=病餘
症候群=症候群
痊愈=痊癒
痒疹=痒疹
痒痒=痒痒
痕迹=痕迹
愈合=癒合
症候=癥候
症状=癥狀
症结=癥結
癸丑=癸丑
发干=發乾
发汗药=發汗藥
发呆=發獃
发蒙=發矇
发签=發籤
发庄=發莊
发着=發著
发表=發表
發表=發表
发松=發鬆
发面=發麵
白干=白乾
白兔擣药=白兔擣藥
白干儿=白干兒
白术=白朮
白朴=白樸
白净面皮=白淨面皮
白发其事=白發其事
白皮松=白皮松
白粉面=白粉麵
白里透红=白裡透紅
白发=白髮
白胡=白鬍
白霉=白黴
百个=百個
百只可=百只可
百只夠=百只夠
百只够=百只夠
百只怕=百只怕
百只足够=百只足夠
百只足夠=百只足夠
百周后=百周後
百多只=百多隻
百天后=百天後
百年=百年
百拙千丑=百拙千醜
百科里=百科裡
百谷=百穀
百扎=百紮
百花历=百花曆
百花历史=百花歷史
百药之长=百藥之長
百炼=百鍊
百只=百隻
百余=百餘
的克制=的剋制
的钟=的鐘
的钟表=的鐘錶
的长发=的長髮
皆可作淀=皆可作澱
皆准=皆準
皇后=皇后
皇历=皇曆
皇极历=皇極曆
皇极历史=皇極歷史
皇历史=皇歷史
皇庄=皇莊
皓发=皓髮
皮制服=皮制服
皮里春秋=皮裡春秋
皮里阳秋=皮裡陽秋
皮制=皮製
皮松=皮鬆
皱别=皺彆
皱折=皺摺
盆吊=盆弔
盈余=盈餘
益于=益於
盒里=盒裡
盛赞=盛讚
盗采=盜採
盗钟=盜鐘
尽量克制=盡量剋制
监制=監製
盘里=盤裡
盘回=盤迴
卢棱伽=盧稜伽
盲干=盲幹
直接参与=直接參与
直于=直於
直冲=直衝
相并=相併
相克制=相克制
相克服=相克服
相克=相剋
相干=相干
相于=相於
相冲=相衝
相斗=相鬥
看下表=看下錶
看下钟=看下鐘
看准=看準
看着表=看著錶
看着钟=看著鐘
看着钟表=看著鐘錶
看表面=看表面
看表=看錶
看钟=看鐘
真凶=真兇
真个=真箇
眼干=眼乾
眼帘=眼帘
眼眶里=眼眶裡
眼睛里=眼睛裡
眼药=眼藥
眼里=眼裡
困乏=睏乏
困倦=睏倦
困觉=睏覺
睡着了=睡著了
睡游病=睡遊病
瞄准=瞄準
瞅下表=瞅下錶
瞅下钟=瞅下鐘
瞧着表=瞧著錶
瞧着钟=瞧著鐘
瞧着钟表=瞧著鐘錶
了望=瞭望
了然=瞭然
了若指掌=瞭若指掌
瞳蒙=瞳矇
蒙事=矇事
蒙昧无知=矇昧無知
蒙混=矇混
蒙瞍=矇瞍
蒙眬=矇矓
蒙聩=矇聵
蒙着=矇著
蒙着锅儿=矇著鍋兒
蒙头转=矇頭轉
蒙骗=矇騙
瞩托=矚託
矜庄=矜莊
短几=短几
短于=短於
短发=短髮
矮几=矮几
石几=石几
石家庄=石家莊
石梁=石樑
石英表=石英錶
石英钟=石英鐘
石英钟表=石英鐘錶
石莼=石蓴
石钟乳=石鐘乳
矽谷=矽谷
研制=研製
砰当=砰噹
朱唇皓齿=硃唇皓齒
朱批=硃批
朱砂=硃砂
朱笔=硃筆
朱红色=硃紅色
朱色=硃色
朱谕=硃諭
硬干=硬幹
确瘠=确瘠
碑志=碑誌
碰钟=碰鐘
码表=碼錶
磁制=磁製
磨制=磨製
磨炼=磨鍊
磬钟=磬鐘
硗确=磽确
碍难照准=礙難照准
砻谷机=礱穀機
示范=示範
社里=社裡
祝赞=祝讚
祝发=祝髮
神荼郁垒=神荼鬱壘
神游=神遊
神雕像=神雕像
神雕=神鵰
票庄=票莊
祭吊=祭弔
祭吊文=祭弔文
禁欲=禁慾
禁欲主义=禁欲主義
禁药=禁藥
祸于=禍於
御侮=禦侮
御寇=禦寇
御寒=禦寒
御敌=禦敵
礼赞=禮讚
禹余粮=禹餘糧
禾谷=禾穀
秃妃之发=禿妃之髮
秃发=禿髮
秀发=秀髮
私下里=私下裡
私欲=私慾
私斗=私鬥
秋假里=秋假裡
秋天里=秋天裡
秋日里=秋日裡
秋裤=秋褲
秋游=秋遊
秋阴入井干=秋陰入井幹
秋发=秋髮
种师中=种師中
种师道=种師道
种放=种放
科学家=科學家
科斗=科斗
科范=科範
秒表明=秒表明
秒表示=秒表示
秒表=秒錶
秒钟=秒鐘
秦庄襄王=秦莊襄王
移祸于=移禍於
稀松=稀鬆
棱台=稜台
棱子=稜子
棱层=稜層
棱柱=稜柱
棱登=稜登
棱棱=稜稜
棱等登=稜等登
棱线=稜線
棱缝=稜縫
棱角=稜角
棱锥=稜錐
棱镜=稜鏡
棱体=稜體
种谷=種穀
称赞=稱讚
稻谷=稻穀
稽征=稽徵
谷人=穀人
谷保家商=穀保家商
谷仓=穀倉
谷圭=穀圭
谷场=穀場
谷子=穀子
谷日=穀日
谷旦=穀旦
谷梁=穀梁
谷壳=穀殼
谷物=穀物
谷皮=穀皮
谷神=穀神
谷谷=穀穀
谷米=穀米
谷粒=穀粒
谷舱=穀艙
谷苗=穀苗
谷草=穀草
谷贵饿农=穀貴餓農
谷贱伤农=穀賤傷農
谷道=穀道
谷雨=穀雨
谷类=穀類
谷食=穀食
穆罕默德历=穆罕默德曆
穆罕默德历史=穆罕默德歷史
积极参与=積极參与
积极参加=積极參加
积淀=積澱
积谷=積穀
积谷防饥=積穀防饑
积郁=積鬱
稳占=穩佔
稳扎=穩紮
空中布雷=空中佈雷
空投布雷=空投佈雷
空蒙=空濛
空荡=空蕩
空荡荡=空蕩蕩
空谷回音=空谷回音
空钟=空鐘
空余=空餘
窒欲=窒慾
窗台上=窗台上
窗帘=窗帘
窗明几亮=窗明几亮
窗明几净=窗明几淨
窗台=窗檯
窝里=窩裡
穷于=窮於
穷追不舍=窮追不捨
穷发=窮髮
窃钟掩耳=竊鐘掩耳
立后综=立后綜
立于=立於
立范=立範
站干岸儿=站乾岸兒
童仆=童僕
端庄=端莊
竞斗=競鬥
竹几=竹几
竹林之游=竹林之遊
竹签=竹籤
竹制=竹製
笑里藏刀=笑裡藏刀
笨笨呆呆=笨笨呆呆
第四出局=第四出局
笔秃墨干=筆禿墨乾
笔试=筆試
等于=等於
笋干=筍乾
筑前=筑前
筑北=筑北
筑州=筑州
筑後=筑後
筑后=筑後
筑波=筑波
筑紫=筑紫
筑肥=筑肥
筑西=筑西
筑邦=筑邦
筑陽=筑陽
筑阳=筑陽
答复=答覆
答覆=答覆
筵几=筵几
个中原因=箇中原因
个中奥妙=箇中奧妙
个中奥秘=箇中奧秘
个中好手=箇中好手
个中强手=箇中強手
个中消息=箇中消息
个中滋味=箇中滋味
个中玄机=箇中玄機
个中理由=箇中理由
个中讯息=箇中訊息
个中资讯=箇中資訊
个中高手=箇中高手
个旧=箇舊
算历=算曆
算历史=算歷史
算准=算準
算发=算髮
管人吊脚儿事=管人弔腳兒事
管制法=管制法
管干=管幹
节欲=節慾
节余=節餘
范例=範例
范围=範圍
范字=範字
范式=範式
范性形变=範性形變
范数=範數
范文=範文
范本=範本
范畴=範疇
范金=範金
简并=簡併
简朴=簡樸
简筑翎=簡筑翎
簡筑翎=簡筑翎
簸荡=簸蕩
签着=簽著
签幐=籤幐
签押=籤押
签条=籤條
签诗=籤詩
吁天=籲天
吁求=籲求
吁请=籲請
米谷=米穀
粉拳绣腿=粉拳繡腿
粉签子=粉籤子
粗制=粗製
精制伏=精制伏
精制住=精制住
精制服=精制服
精干=精幹
精于=精於
精准=精準
精致=精緻
精制=精製
精炼=精鍊
精辟=精闢
精松=精鬆
糊里糊涂=糊裡糊塗
糕干=糕乾
粪秽蔑面=糞穢衊面
团子=糰子
系列里=系列裡
系着=系著
系里=系裡
纪历=紀曆
纪历史=紀歷史
约占=約佔
红后假说=紅后假說
红绳系足=紅繩繫足
红色长发=紅色長髮
红钟=紅鐘
红霉素=紅霉素
红发=紅髮
纡回=紆迴
纡余=紆餘
纡郁=紆鬱
纳征=納徵
纯朴=純樸
纸扎=紙紮
素朴=素樸
素发=素髮
素面=素麵
索马里=索馬里
索馬里=索馬里
索面=索麵
紫姜=紫薑
扎上=紮上
扎下=紮下
扎囮=紮囮
扎好=紮好
扎实=紮實
扎寨=紮寨
扎带子=紮帶子
扎成=紮成
扎根=紮根
扎营=紮營
扎紧=紮緊
扎脚=紮腳
扎裹=紮裹
扎诈=紮詐
扎起=紮起
扎铁=紮鐵
细不容发=細不容髮
细如发=細如髮
细致=細緻
细炼=細鍊
终于=終於
组里=組裡
结伴同游=結伴同遊
结伙=結夥
结扎=結紮
结彩=結綵
结余=結餘
结发=結髮
绝对参照=絕對參照
绝于=絕於
绞干=絞乾
络腮胡=絡腮鬍
給我干脆=給我干脆
给我干脆=給我干脆
给于=給於
丝来线去=絲來線去
丝布=絲布
丝恩发怨=絲恩髮怨
丝板=絲板
丝瓜布=絲瓜布
丝绒布=絲絨布
丝线=絲線
丝织厂=絲織廠
丝虫=絲蟲
丝制=絲製
丝发=絲髮
绑扎=綁紮
綑扎=綑紮
经有云=經有云
經有云=經有云
绿发=綠髮
绸缎庄=綢緞莊
维系=維繫
绾发=綰髮
网里=網裡
网志=網誌
网游=網遊
彩带=綵帶
彩排=綵排
彩楼=綵樓
彩牌楼=綵牌樓
彩球=綵球
彩绸=綵綢
彩线=綵線
彩船=綵船
彩衣=綵衣
紧致=緊緻
紧绷=緊繃
紧绷绷=緊繃繃
紧绷着=緊繃著
紧追不舍=緊追不捨
绪余=緒餘
緝凶=緝兇
缉凶=緝兇
编余=編余
编制法=編制法
编采=編採
编码表=編碼表
编制=編製
编钟=編鐘
编发=編髮
缓征=緩徵
缓冲=緩衝
致密=緻密
萦回=縈迴
缜致=縝緻
县里=縣裡
县志=縣誌
缝里=縫裡
缝制=縫製
缩栗=縮慄
纵欲=縱慾
纤夫=縴夫
纤手=縴手
总裁制=總裁制
繁复=繁複
繁钟=繁鐘
绷住=繃住
绷子=繃子
绷带=繃帶
绷扒吊拷=繃扒弔拷
绷紧=繃緊
绷脸=繃臉
绷着=繃著
绷着脸=繃著臉
绷着脸儿=繃著臉兒
绷开=繃開
穗帏飘井干=繐幃飄井幹
绕梁=繞樑
绣像=繡像
绣口=繡口
绣得=繡得
绣户=繡戶
绣房=繡房
绣毯=繡毯
绣球=繡球
绣的=繡的
绣花=繡花
绣衣=繡衣
绣起=繡起
绣阁=繡閣
绣鞋=繡鞋
绘制=繪製
系上=繫上
系世=繫世
系到=繫到
系囚=繫囚
系心=繫心
系念=繫念
系怀=繫懷
系恋=繫戀
系于=繫於
系于一发=繫於一髮
系结=繫結
系紧=繫緊
系绳=繫繩
系累=繫纍
系辞=繫辭
系风捕影=繫風捕影
累囚=纍囚
累堆=纍堆
累瓦结绳=纍瓦結繩
累绁=纍紲
累臣=纍臣
缠斗=纏鬥
才则=纔則
才可容颜十五余=纔可容顏十五餘
才得两年=纔得兩年
才此=纔此
坛子=罈子
坛坛罐罐=罈罈罐罐
坛騞=罈騞
置于=置於
置言成范=置言成範
骂着=罵著
罢于=罷於
羁系=羈繫
美占=美佔
美仑=美崙
美于=美於
美制=美製
美丑=美醜
美发=美髮
群丑=群醜
羡余=羨餘
义占=義佔
义仆=義僕
义庄=義莊
翕辟=翕闢
翱游=翱遊
翻涌=翻湧
翻云覆雨=翻雲覆雨
翻松=翻鬆
老干=老乾
老仆=老僕
老干部=老幹部
老蒙=老懞
老于=老於
老爷钟=老爺鐘
老庄=老莊
老姜=老薑
老板=老闆
老面皮=老面皮
考征=考徵
考试=考試
而克制=而剋制
耍斗=耍鬥
耕佣=耕傭
耕获=耕穫
耳余=耳餘
耿于=耿於
聊斋志异=聊齋志異
圣后=聖后
聘雇=聘僱
闻风后=聞風後
联系=聯繫
听于=聽於
肉干=肉乾
肉欲=肉慾
肉丝面=肉絲麵
肉羹面=肉羹麵
肉松=肉鬆
肚里=肚裡
肝脏=肝臟
肝郁=肝鬱
股栗=股慄
肥筑方言=肥筑方言
肴馔=肴饌
肺脏=肺臟
胃药=胃藥
胃里=胃裡
背向着=背向著
背地里=背地裡
胎发=胎髮
胜肽=胜肽
胜键=胜鍵
胡云=胡云
胡子昂=胡子昂
胡朴安=胡樸安
胡里胡涂=胡裡胡塗
能克制=能剋制
能干休=能干休
能干戈=能干戈
能干扰=能干擾
能干政=能干政
能干涉=能干涉
能干预=能干預
能干=能幹
能自制=能自制
脉冲=脈衝
脊梁背=脊梁背
脊梁骨=脊梁骨
脊梁=脊樑
脱谷机=脫穀機
脱发=脫髮
脾脏=脾臟
腊之以为饵=腊之以為餌
腊味=腊味
腊毒=腊毒
腊笔=腊筆
肾脏=腎臟
腐干=腐乾
腐余=腐餘
腕表=腕錶
脑子里=腦子裡
脑干=腦幹
腰里=腰裡
脚注=腳註
脚炼=腳鍊
膏药=膏藥
肤发=膚髮
胶卷=膠捲
膨松=膨鬆
臣仆=臣僕
卧游=臥遊
臧谷亡羊=臧穀亡羊
临潼斗宝=臨潼鬥寶
自制一下=自制一下
自制下来=自制下來
自制不=自制不
自制之力=自制之力
自制之能=自制之能
自制他=自制他
自制伏=自制伏
自制你=自制你
自制力=自制力
自制地=自制地
自制她=自制她
自制情=自制情
自制我=自制我
自制服=自制服
自制的能=自制的能
自制能力=自制能力
自于=自於
自制=自製
自觉自愿=自覺自愿
至多=至多
至于=至於
致于=致於
臻于=臻於
舂谷=舂穀
与克制=與剋制
兴致=興緻
举手表=舉手表
举手表决=舉手表決
旧庄=舊庄
旧历=舊曆
旧历史=舊歷史
旧药=舊藥
旧游=舊遊
旧表=舊錶
旧钟=舊鐘
旧钟表=舊鐘錶
舌干唇焦=舌乾唇焦
舒卷=舒捲
舞后=舞后
航海历=航海曆
航海历史=航海歷史
船只得=船只得
船只有=船只有
船只能=船只能
船钟=船鐘
船只=船隻
舰只=艦隻
良药=良藥
色欲=色慾
艷后=艷后
艳后=艷后
艸木丰丰=艸木丰丰
芍药=芍藥
芒果干=芒果乾
花拳绣腿=花拳繡腿
花卷=花捲
花盆里=花盆裡
花庵词选=花菴詞選
花药=花藥
花钟=花鐘
花马吊嘴=花馬弔嘴
花哄=花鬨
苑里=苑裡
若干=若干
苦干=苦幹
苦药=苦藥
苦里=苦裡
苦斗=苦鬥
苎麻=苧麻
英占=英佔
苹萦=苹縈
茂都淀=茂都澱
范文同=范文同
范文正公=范文正公
范文瀾=范文瀾
范文澜=范文瀾
范文照=范文照
范文程=范文程
范文芳=范文芳
范文藤=范文藤
范文虎=范文虎
范登堡=范登堡
范贤惠=范賢惠
范賢惠=范賢惠
茶几=茶几
茶庄=茶莊
茶余=茶餘
茶面=茶麵
草丛里=草叢裡
草荐=草荐
草药=草藥
荐居=荐居
荐臻=荐臻
荐饥=荐饑
荷花淀=荷花澱
庄上=莊上
庄主=莊主
庄周=莊周
庄员=莊員
庄严=莊嚴
庄园=莊園
庄士顿道=莊士頓道
庄子=莊子
庄客=莊客
庄家=莊家
庄户=莊戶
庄房=莊房
庄敬=莊敬
庄田=莊田
庄稼=莊稼
庄舄越吟=莊舄越吟
庄里=莊裡
庄语=莊語
庄农=莊農
庄重=莊重
庄院=莊院
庄骚=莊騷
茎干=莖幹
莜面=莜麵
莽荡=莽蕩
菌丝体=菌絲體
菜干=菜乾
菜肴=菜肴
菠棱菜=菠稜菜
菠萝干=菠蘿乾
华严钟=華嚴鐘
华发=華髮
萬一只=萬一只
万一只=萬一只
万个=萬個
万周后=萬周後
万多只=萬多隻
万天后=萬天後
万年=萬年
万年历=萬年曆
万年历表=萬年曆錶
万历=萬曆
万历史=萬歷史
万签插架=萬籤插架
万扎=萬紮
万象=萬象
万只=萬隻
万余=萬餘
落腮胡=落腮鬍
落发=落髮
叶叶琴=葉叶琴
叶叶琹=葉叶琹
着儿=著兒
着克制=著剋制
着书立说=著書立說
着色软体=著色軟體
着重指出=著重指出
着录=著錄
着录规则=著錄規則
葡占=葡佔
葡萄干=葡萄乾
董氏封发=董氏封髮
葫芦里卖甚么药=葫蘆裡賣甚麼藥
蒙汗药=蒙汗藥
蒙庄=蒙莊
蒙雾露=蒙霧露
蒜发=蒜髮
苍术=蒼朮
苍发=蒼髮
苍郁=蒼鬱
蓄发=蓄髮
蓄胡=蓄鬍
蓄须=蓄鬚
蓊郁=蓊鬱
蓬蓬松松=蓬蓬鬆鬆
蓬发=蓬髮
蓬松=蓬鬆
参绥=蔘綏
葱郁=蔥鬱
荞麦面=蕎麥麵
荡来荡去=蕩來蕩去
荡女=蕩女
荡妇=蕩婦
荡寇=蕩寇
荡平=蕩平
荡气回肠=蕩氣迴腸
荡涤=蕩滌
荡漾=蕩漾
荡然=蕩然
荡产=蕩產
荡舟=蕩舟
荡船=蕩船
荡荡=蕩蕩
萧参=蕭蔘
薄幸=薄倖
薄干=薄幹
姜是老的辣=薑是老的辣
姜末=薑末
姜桂=薑桂
姜母=薑母
姜汁=薑汁
姜汤=薑湯
姜片=薑片
姜糖=薑糖
姜丝=薑絲
姜老辣=薑老辣
姜茶=薑茶
姜蓉=薑蓉
姜饼=薑餅
姜黄=薑黃
薙发=薙髮
薝卜=薝蔔
苧悴=薴悴
薴烯=薴烯
苧烯=薴烯
借以=藉以
借助=藉助
借寇兵=藉寇兵
借手=藉手
借机=藉機
借此=藉此
借由=藉由
借箸代筹=藉箸代籌
借着=藉著
借资=藉資
蓝淀=藍澱
藏于=藏於
藏历=藏曆
藏历史=藏歷史
藏蒙歌儿=藏矇歌兒
藤制=藤製
药丸=藥丸
药典=藥典
药到命除=藥到命除
药到病除=藥到病除
药剂=藥劑
药力=藥力
药包=藥包
药名=藥名
药味=藥味
药品=藥品
药商=藥商
药单=藥單
药婆=藥婆
药学=藥學
药害=藥害
药专=藥專
药局=藥局
药师=藥師
药店=藥店
药厂=藥廠
药引=藥引
药性=藥性
药房=藥房
药效=藥效
药方=藥方
药材=藥材
药棉=藥棉
药检局=藥檢局
药水=藥水
药油=藥油
药液=藥液
药渣=藥渣
药片=藥片
药物=藥物
药王=藥王
药理=藥理
药瓶=藥瓶
药用=藥用
药皂=藥皂
药盒=藥盒
药石=藥石
药科=藥科
药箱=藥箱
药签=藥籤
药粉=藥粉
药糖=藥糖
药线=藥線
药罐=藥罐
药膏=藥膏
药舖=藥舖
药茶=藥茶
药草=藥草
药行=藥行
药贩=藥販
药费=藥費
药酒=藥酒
药医学系=藥醫學系
药量=藥量
药针=藥針
药铺=藥鋪
药头=藥頭
药饵=藥餌
药面儿=藥麵兒
苏昆=蘇崑
蕴含着=蘊含著
蕴涵着=蘊涵著
苹果干=蘋果乾
萝卜=蘿蔔
萝卜干=蘿蔔乾
虎须=虎鬚
虎斗=虎鬥
号志=號誌
虫部=虫部
蚊动牛斗=蚊動牛鬥
蛇发女妖=蛇髮女妖
蛔虫药=蛔蟲藥
蜂后=蜂后
蜂涌=蜂湧
蜂准=蜂準
蜜里调油=蜜裡調油
蜡月=蜡月
蜡祭=蜡祭
蝎蝎螫螫=蝎蝎螫螫
蝎谮=蝎譖
虮蝨相吊=蟣蝨相弔
蛏干=蟶乾
蚁后=蟻后
蟻后=蟻后
蠁干=蠁幹
蛮干=蠻幹
血拼=血拚
血余=血餘
行事历=行事曆
行事历史=行事歷史
行凶=行兇
行凶前=行兇前
行凶後=行兇後
行于=行於
行百里者半于九十=行百里者半於九十
卫后庄公=衛後莊公
卫星钟=衛星鐘
冲上=衝上
冲下=衝下
冲来=衝來
冲倒=衝倒
冲冠=衝冠
冲出=衝出
冲到=衝到
冲刺=衝刺
冲克=衝剋
冲力=衝力
冲劲=衝勁
冲动=衝動
冲去=衝去
冲口=衝口
冲垮=衝垮
冲堂=衝堂
冲坚陷阵=衝堅陷陣
冲压=衝壓
冲天=衝天
冲州撞府=衝州撞府
冲心=衝心
冲掉=衝掉
冲撞=衝撞
冲击=衝擊
冲散=衝散
冲杀=衝殺
冲决=衝決
冲波=衝波
冲浪=衝浪
冲激=衝激
冲然=衝然
冲盹=衝盹
冲破=衝破
冲程=衝程
冲突=衝突
冲线=衝線
冲着=衝著
冲要=衝要
冲起=衝起
冲车=衝車
冲进=衝進
冲过=衝過
冲量=衝量
冲锋=衝鋒
冲陷=衝陷
冲头阵=衝頭陣
冲风=衝風
衣绣昼行=衣繡晝行
表征=表徵
表里=表裡
表面=表面
衷于=衷於
袋里=袋裡
袋表=袋錶
袖里=袖裡
被里=被裡
被复=被複
被覆着=被覆著
被发佯狂=被髮佯狂
被发入山=被髮入山
被发左衽=被髮左衽
被发缨冠=被髮纓冠
被发阳狂=被髮陽狂
裁并=裁併
裁制=裁製
里手=裏手
里海=裏海
补于=補於
补药=補藥
补血药=補血藥
补注=補註
装折=裝摺
里勾外连=裡勾外連
里屋=裡屋
里层=裡層
里布=裡布
里带=裡帶
里弦=裡弦
里应外合=裡應外合
里脊=裡脊
里衣=裡衣
里通外国=裡通外國
里通外敌=裡通外敵
里边=裡邊
里间=裡間
里面=裡面
里面包=裡面包
里头=裡頭
制件=製件
制作=製作
制做=製做
制备=製備
制冰=製冰
制冷=製冷
制剂=製劑
制取=製取
制品=製品
制图=製圖
制得=製得
制成=製成
制法=製法
制浆=製漿
制为=製為
制片=製片
制版=製版
制程=製程
制糖=製糖
制纸=製紙
制药=製藥
制表=製表
制造=製造
制革=製革
制鞋=製鞋
制盐=製鹽
复仞年如=複仞年如
复以百万=複以百萬
复位=複位
复信=複信
复元音=複元音
复函数=複函數
复分数=複分數
复分析=複分析
复分解=複分解
复列=複列
复利=複利
复印=複印
复句=複句
复合=複合
复名=複名
复员=複員
复壁=複壁
复壮=複壯
复姓=複姓
复字键=複字鍵
复审=複審
复写=複寫
复对数=複對數
复平面=複平面
复式=複式
复复=複復
复数=複數
复本=複本
复查=複查
复核=複核
复检=複檢
复次=複次
复比=複比
复决=複決
复流=複流
复测=複測
复亩珍=複畝珍
复发=複發
复目=複目
复眼=複眼
复种=複種
复线=複線
复习=複習
复色=複色
复叶=複葉
复制=複製
复诊=複診
复评=複評
复词=複詞
复试=複試
复课=複課
复议=複議
复变函数=複變函數
复赛=複賽
复辅音=複輔音
复述=複述
复选=複選
复钱=複錢
复阅=複閱
复杂=複雜
复电=複電
复音=複音
复韵=複韻
褒赞=褒讚
衬里=襯裡
西占=西佔
西周钟=西周鐘
西岳=西嶽
西晒=西晒
西历=西曆
西历史=西歷史
西米谷=西米谷
西药=西藥
西西里=西西里
西谷米=西谷米
西游=西遊
要占=要佔
要克制=要剋制
要占卜=要占卜
要自制=要自制
要冲=要衝
要么=要麼
覆亡=覆亡
覆命=覆命
覆巢之下无完卵=覆巢之下無完卵
覆水难收=覆水難收
覆没=覆沒
覆着=覆著
覆盖=覆蓋
覆盖着=覆蓋著
覆辙=覆轍
覆雨翻云=覆雨翻雲
见于=見於
见棱见角=見稜見角
见素抱朴=見素抱樸
见钟不打=見鐘不打
规范=規範
視如寇仇=視如寇讎
视于=視於
观采=觀採
角落发=角落發
角落里=角落裡
觚棱=觚稜
解雇=解僱
解痛药=解痛藥
解药=解藥
解铃仍须系铃人=解鈴仍須繫鈴人
解铃还须系铃人=解鈴還須繫鈴人
解发佯狂=解髮佯狂
触须=觸鬚
言云=言云
言大而夸=言大而夸
言辩而确=言辯而确
订制=訂製
计划=計劃
计时表=計時錶
托了=託了
托事=託事
托交=託交
托人=託人
托付=託付
托儿所=託兒所
托古讽今=託古諷今
托名=託名
托命=託命
托咎=託咎
托梦=託夢
托大=託大
托孤=託孤
托庇=託庇
托故=託故
托疾=託疾
托病=託病
托管=託管
托言=託言
托词=託詞
托买=託買
托卖=託賣
托身=託身
托辞=託辭
托运=託運
托过=託過
托附=託附
许愿起经=許愿起經
许虬=許虬
诉说着=訴說著
注上=註上
注册=註冊
注失=註失
注定=註定
注明=註明
注标=註標
注生娘娘=註生娘娘
注疏=註疏
注脚=註腳
注解=註解
注记=註記
注译=註譯
注销=註銷
注：=註：
评断发=評斷發
评注=評註
词干=詞幹
词汇=詞彙
词余=詞餘
询于=詢於
询于刍荛=詢於芻蕘
试药=試藥
试制=試製
诗云=詩云
詩云=詩云
诗赞=詩讚
诗钟=詩鐘
诗余=詩餘
话里有话=話裡有話
该钟=該鐘
详征博引=詳徵博引
详注=詳註
诔赞=誄讚
夸多斗靡=誇多鬥靡
夸能斗智=誇能鬥智
夸赞=誇讚
志哀=誌哀
志喜=誌喜
志庆=誌慶
志异=誌異
认准=認準
诱奸=誘姦
语云=語云
语汇=語彙
语有云=語有云
語有云=語有云
诚征=誠徵
诚朴=誠樸
诬蔑=誣衊
说着=說著
谁干的=誰幹的
课征=課徵
课余=課餘
调准=調準
调制=調製
调表=調錶
调钟表=調鐘錶
谈征=談徵
请参阅=請參閱
请君入瓮=請君入甕
请求=請求
请托=請託
咨询=諮詢
诸余=諸餘
谋干=謀幹
谢绝参观=謝絕參觀
谢华后=謝華后
谬采虚声=謬採虛聲
谬赞=謬讚
謷丑=謷醜
谨于心=謹於心
警世钟=警世鐘
警报钟=警報鐘
警示钟=警示鐘
警钟=警鐘
译注=譯註
护发=護髮
变征=變徵
变丑=變醜
变脏=變髒
变髒=變髒
仇問=讎問
仇夷=讎夷
仇校=讎校
仇正=讎正
仇隙=讎隙
赞不绝口=讚不絕口
赞佩=讚佩
赞呗=讚唄
赞叹不已=讚嘆不已
赞扬=讚揚
赞乐=讚樂
赞歌=讚歌
赞叹=讚歎
赞美=讚美
赞羡=讚羨
赞许=讚許
赞词=讚詞
赞誉=讚譽
赞赏=讚賞
赞辞=讚辭
赞颂=讚頌
豆干=豆乾
豆腐干=豆腐乾
竖着=豎著
竖起脊梁=豎起脊梁
丰滨=豐濱
丰滨乡=豐濱鄉
象征=象徵
象征着=象徵著
负债累累=負債纍纍
贪欲=貪慾
贵价=貴价
贵干=貴幹
贵征=貴徵
買凶=買兇
买凶=買兇
买断发=買斷發
费占=費佔
贻范=貽範
资金占用=資金占用
贾后=賈后
賈后=賈后
赈饥=賑饑
赏赞=賞讚
贤后=賢后
賢后=賢后
卖断发=賣斷發
卖呆=賣獃
质朴=質樸
赌后=賭后
赌台=賭檯
赌斗=賭鬥
賸余=賸餘
购并=購併
购买欲=購買慾
赢余=贏餘
赤术=赤朮
赤绳系足=赤繩繫足
赤霉素=赤霉素
走回路=走回路
起复=起複
起哄=起鬨
超级杯=超級盃
赶制=趕製
赶面棍=趕麵棍
赵威后=趙威后
赵惠后=趙惠后
赵治勋=趙治勳
赵庄=趙莊
趱干=趲幹
足于=足於
跌扑=跌扑
跌荡=跌蕩
路签=路籤
跳梁小丑=跳樑小丑
跳荡=跳蕩
跳表=跳錶
蹪于=蹪於
蹭棱子=蹭稜子
躁郁=躁鬱
身于=身於
身体发肤=身體髮膚
躯干=軀幹
车库里=車庫裡
车站里=車站裡
车里=車裡
轨范=軌範
军队克制=軍隊剋制
轩辟=軒闢
较于=較於
挽曲=輓曲
挽歌=輓歌
挽聯=輓聯
挽联=輓聯
挽詞=輓詞
挽词=輓詞
挽诗=輓詩
挽詩=輓詩
轻于=輕於
轻轻松松=輕輕鬆鬆
轻松=輕鬆
轮奸=輪姦
轮回=輪迴
转向往=轉向往
转台=轉檯
转托=轉託
转斗千里=轉鬥千里
辛丑=辛丑
辟谷=辟穀
办公台=辦公檯
辞汇=辭彙
辫发=辮髮
辩斗=辯鬥
农历=農曆
农历史=農歷史
农民历=農民曆
农民历史=農民歷史
农庄=農莊
农药=農藥
迂回=迂迴
近日無仇=近日無讎
近日里=近日裡
返朴=返樸
迥然回异=迥然迴異
迫于=迫於
回光返照=迴光返照
回向=迴向
回圈=迴圈
回廊=迴廊
回形夹=迴形夾
回文=迴文
回旋=迴旋
回流=迴流
回环=迴環
回纹针=迴紋針
回绕=迴繞
回翔=迴翔
回肠=迴腸
回诵=迴誦
回路=迴路
回转=迴轉
回递性=迴遞性
回避=迴避
回銮=迴鑾
回音=迴音
回响=迴響
回风=迴風
迷幻药=迷幻藥
迷于=迷於
迷蒙=迷濛
迷药=迷藥
迷魂药=迷魂藥
追凶=追兇
退伙=退夥
退烧药=退燒藥
退藏于密=退藏於密
逆钟=逆鐘
逆钟向=逆鐘向
逆风后=逆風後
逋发=逋髮
逍遥游=逍遙遊
透辟=透闢
这只不=這只不
这只允=這只允
这只可=這只可
这只在=這只在
这只容=這只容
这只采=這只採
这只是=這只是
这只会=這只會
这只用=這只用
这只能=這只能
这只需=這只需
这伙人=這夥人
这里=這裡
这钟=這鐘
这只=這隻
这么=這麼
这么着=這麼著
通奸=通姦
通心面=通心麵
通于=通於
通历=通曆
通历史=通歷史
通庄=通莊
逞凶鬥狠=逞兇鬥狠
逞凶斗狠=逞兇鬥狠
造钟=造鐘
造钟表=造鐘錶
造曲=造麯
连三并四=連三併四
连占=連佔
连采=連採
连系=連繫
连庄=連莊
周游世界=週遊世界
进占=進佔
進制=進制
进制=進制
逼并=逼併
遇风后=遇風後
游了=遊了
游人=遊人
游仙=遊仙
游伴=遊伴
游侠=遊俠
游冶=遊冶
游刃有余=遊刃有餘
游动=遊動
游园=遊園
游子=遊子
游学=遊學
游客=遊客
游宦=遊宦
游山玩水=遊山玩水
游必有方=遊必有方
游憩=遊憩
游戏=遊戲
游手好闲=遊手好閒
游方=遊方
游星=遊星
游乐=遊樂
游标卡尺=遊標卡尺
游历=遊歷
游民=遊民
游河=遊河
游猎=遊獵
游玩=遊玩
游荡=遊盪
游目骋怀=遊目騁懷
游程=遊程
游丝=遊絲
游兴=遊興
游船=遊船
游艇=遊艇
游荡不归=遊蕩不歸
游艺=遊藝
游行=遊行
游街=遊街
游览=遊覽
游记=遊記
游说=遊說
游资=遊資
游走=遊走
游踪=遊蹤
游逛=遊逛
游错=遊錯
游离份子=遊離份子
游离票=遊離票
游骑兵=遊騎兵
游魂=遊魂
过于=過於
过杆=過杆
过水面=過水麵
道范=道範
逊于=遜於
递回=遞迴
远县才至=遠縣纔至
远游=遠遊
遨游=遨遊
遮丑=遮醜
迁于=遷於
选手=選手
选手表明=選手表明
选手表决=選手表決
选手表现=選手表現
选手表示=選手表示
选手表达=選手表達
遗传钟=遺傳鐘
遗范=遺範
遗迹=遺迹
辽沈=遼瀋
避孕药=避孕藥
邀天之幸=邀天之倖
还占=還佔
还采=還採
还冲=還衝
邋里邋遢=邋裡邋遢
那只可=那只可
那只在=那只在
那只是=那只是
那只会=那只會
那只有=那只有
那只用=那只用
那只能=那只能
那只需=那只需
那卷=那捲
那里=那裡
那只=那隻
那么=那麼
那么着=那麼著
邱于庭=邱于庭
郁朴=郁樸
郁郁菲菲=郁郁菲菲
郁郁青青=郁郁青青
郊游=郊遊
郘钟=郘鐘
部落发=部落發
郭后=郭后
都于=都於
鄉愿=鄉愿
乡愿=鄉愿
鄭凱云=鄭凱云
郑凯云=鄭凱云
郑庄公=鄭莊公
配制饲料=配制飼料
配合着=配合著
配水干管=配水幹管
配药=配藥
配制=配製
酒帘=酒帘
酒坛=酒罈
酒肴=酒肴
酒药=酒藥
酒醴曲蘖=酒醴麴櫱
酒曲=酒麴
酥松=酥鬆
醇朴=醇樸
醉于=醉於
醋坛=醋罈
丑丫头=醜丫頭
丑事=醜事
丑人=醜人
丑侪=醜儕
丑八怪=醜八怪
丑剌剌=醜剌剌
丑剧=醜劇
丑化=醜化
丑史=醜史
丑名=醜名
丑咤=醜吒
丑地=醜地
丑夷=醜夷
丑女=醜女
丑女效颦=醜女效顰
丑奴儿=醜奴兒
丑妇=醜婦
丑媳=醜媳
丑媳妇=醜媳婦
丑小鸭=醜小鴨
丑巴怪=醜巴怪
丑徒=醜徒
丑恶=醜惡
丑态=醜態
丑毙了=醜斃了
丑于=醜於
丑末=醜末
丑样=醜樣
丑死=醜死
丑比=醜比
丑沮=醜沮
丑男=醜男
丑闻=醜聞
丑声=醜聲
丑声远播=醜聲遠播
丑脸=醜臉
丑虏=醜虜
丑行=醜行
丑言=醜言
丑诋=醜詆
丑话=醜話
丑语=醜語
丑贼生=醜賊生
丑辞=醜辭
丑辱=醜辱
丑逆=醜逆
丑丑=醜醜
丑陋=醜陋
丑杂=醜雜
丑头怪脸=醜頭怪臉
丑类=醜類
酝酿着=醞釀著
医药=醫藥
医院里=醫院裡
酿制=釀製
衅钟=釁鐘
采石之役=采石之役
采石之战=采石之戰
采石之戰=采石之戰
采石磯=采石磯
采石矶=采石磯
釉药=釉藥
里程表=里程錶
重回=重回
重折=重摺
重于=重於
重罗面=重羅麵
重制=重製
重复=重複
重托=重託
重游=重遊
重锤=重鎚
野姜=野薑
野游=野遊
厘出=釐出
厘升=釐升
厘定=釐定
厘正=釐正
厘清=釐清
厘订=釐訂
金仆姑=金僕姑
金仑溪=金崙溪
金布道=金布道
金范=金範
金色长发=金色長髮
金表情=金表情
金表态=金表態
金表扬=金表揚
金表明=金表明
金表演=金表演
金表现=金表現
金表示=金表示
金表达=金表達
金表露=金表露
金表面=金表面
金装玉里=金裝玉裡
金表=金錶
金钟=金鐘
金马仑道=金馬崙道
金发=金髮
钉锤=釘鎚
钩心斗角=鈎心鬥角
银朱=銀硃
银发=銀髮
铜范=銅範
铜制=銅製
铜钟=銅鐘
铯钟=銫鐘
铝制=鋁製
铺锦列绣=鋪錦列繡
钢之炼金术师=鋼之鍊金術師
钢梁=鋼樑
钢制=鋼製
录着=錄著
录制=錄製
锤炼=錘鍊
钱谷=錢穀
钱范=錢範
钱庄=錢莊
锦绣花园=錦綉花園
锦绣=錦繡
表停=錶停
表冠=錶冠
表带=錶帶
表店=錶店
表厂=錶廠
表快=錶快
表慢=錶慢
表板=錶板
表壳=錶殼
表王=錶王
表的嘀嗒=錶的嘀嗒
表的历史=錶的歷史
表盘=錶盤
表蒙子=錶蒙子
表行=錶行
表转=錶轉
表速=錶速
表针=錶針
表链=錶鏈
炼冶=鍊冶
炼句=鍊句
炼字=鍊字
炼师=鍊師
炼度=鍊度
炼形=鍊形
炼气=鍊氣
炼汞=鍊汞
炼石=鍊石
炼贫=鍊貧
炼金术=鍊金術
炼钢=鍊鋼
锅庄=鍋莊
锻炼出=鍛鍊出
锲而不舍=鍥而不捨
镰仓=鎌倉
锤儿=鎚兒
锤子=鎚子
锤头=鎚頭
锈病=鏽病
锈菌=鏽菌
锈蚀=鏽蝕
钟上=鐘上
钟下=鐘下
钟不=鐘不
钟不扣不鸣=鐘不扣不鳴
钟不撞不鸣=鐘不撞不鳴
钟不敲不响=鐘不敲不響
钟不空则哑=鐘不空則啞
钟乳洞=鐘乳洞
钟乳石=鐘乳石
钟停=鐘停
钟匠=鐘匠
钟口=鐘口
钟在寺里=鐘在寺裡
钟塔=鐘塔
钟壁=鐘壁
钟太=鐘太
钟好=鐘好
钟山=鐘山
钟左右=鐘左右
钟差=鐘差
钟座=鐘座
钟形=鐘形
钟形虫=鐘形蟲
钟律=鐘律
钟快=鐘快
钟意=鐘意
钟慢=鐘慢
钟摆=鐘擺
钟敲=鐘敲
钟有=鐘有
钟楼=鐘樓
钟模=鐘模
钟没=鐘沒
钟漏=鐘漏
钟王=鐘王
钟琴=鐘琴
钟发音=鐘發音
钟的=鐘的
钟盘=鐘盤
钟相=鐘相
钟磬=鐘磬
钟纽=鐘紐
钟罩=鐘罩
钟声=鐘聲
钟腰=鐘腰
钟螺=鐘螺
钟行=鐘行
钟表面=鐘表面
钟被=鐘被
钟调=鐘調
钟身=鐘身
钟速=鐘速
钟表=鐘錶
钟表停=鐘錶停
钟表快=鐘錶快
钟表慢=鐘錶慢
钟表历史=鐘錶歷史
钟表王=鐘錶王
钟表的=鐘錶的
钟表的历史=鐘錶的歷史
钟表盘=鐘錶盤
钟表行=鐘錶行
钟表速=鐘錶速
钟关=鐘關
钟陈列=鐘陳列
钟面=鐘面
钟响=鐘響
钟顶=鐘頂
钟头=鐘頭
钟体=鐘體
钟鸣=鐘鳴
钟点=鐘點
钟鼎=鐘鼎
钟鼓=鐘鼓
铁杆=鐵杆
铁栏杆=鐵欄杆
铁锤=鐵鎚
铁锈=鐵鏽
铁钟=鐵鐘
铸钟=鑄鐘
鉴于=鑒於
长几=長几
长于=長於
长历=長曆
长历史=長歷史
长生药=長生藥
长胡=長鬍
门帘=門帘
门吊儿=門弔兒
门里=門裡
闫怀礼=閆懷禮
开吊=開弔
开征=開徵
开采=開採
开发=開發
开药=開藥
开辟=開闢
开哄=開鬨
闲情逸致=閒情逸緻
闲荡=閒蕩
闲游=閒遊
间不容发=間不容髮
闵采尔=閔採爾
合府=閤府
闺范=閨範
阃范=閫範
闯荡=闖蕩
闯炼=闖鍊
关系=關係
关系着=關係著
关弓与我确=關弓與我确
关于=關於
辟佛=闢佛
辟作=闢作
辟划=闢劃
辟土=闢土
辟地=闢地
辟室=闢室
辟建=闢建
辟为=闢為
辟田=闢田
辟筑=闢築
辟谣=闢謠
辟辟=闢辟
辟邪以律=闢邪以律
防晒=防晒
防水表=防水錶
防御=防禦
防范=防範
防锈=防鏽
防台=防颱
阻于=阻於
阿呆瓜=阿呆瓜
阿斯图里亚斯=阿斯圖里亞斯
阿呆=阿獃
阿里=阿里
附于=附於
附注=附註
降压药=降壓藥
限制=限制
升官=陞官
除臭药=除臭藥
陪吊=陪弔
阴干=陰乾
阴历=陰曆
阴历史=陰歷史
阴沟里翻船=陰溝裡翻船
阴郁=陰鬱
陈冲=陳冲
陳冲=陳冲
陈有后=陳有后
陈炼=陳鍊
陆游=陸遊
阳春面=陽春麵
阳历=陽曆
阳历史=陽歷史
隆准许=隆准許
隆准=隆準
随于=隨於
隐占=隱佔
隐几=隱几
隐于=隱於
只字=隻字
只影=隻影
只手遮天=隻手遮天
只眼=隻眼
只言片语=隻言片語
只身=隻身
雄斗斗=雄斗斗
雅范=雅範
雅致=雅緻
集于=集於
集游法=集遊法
雕梁画栋=雕樑畫棟
双折射=雙折射
双折=雙摺
双胜类=雙胜類
双雕=雙鵰
杂合面儿=雜合麵兒
杂志=雜誌
杂面=雜麵
鸡吵鹅斗=雞吵鵝鬥
鸡奸=雞姦
鸡争鹅斗=雞爭鵝鬥
鸡丝=雞絲
鸡丝面=雞絲麵
鸡腿面=雞腿麵
鸡蛋里挑骨头=雞蛋裡挑骨頭
鸡只=雞隻
离于=離於
难舍=難捨
难于=難於
雪窗萤几=雪窗螢几
雪里=雪裡
雪里红=雪裡紅
雪里蕻=雪裡蕻
云南白药=雲南白藥
云笈七签=雲笈七籤
云游=雲遊
云须=雲鬚
零个=零個
零周后=零周後
零多只=零多隻
零天后=零天後
零年=零年
零只=零隻
零余=零餘
电子表格=電子表格
电子表=電子錶
电子钟=電子鐘
电子钟表=電子鐘錶
电杆=電杆
电波钟=電波鐘
电码表=電碼表
电线杆=電線杆
电冲=電衝
电表=電錶
电钟=電鐘
震栗=震慄
震荡=震蕩
雾里=霧裡
露丑=露醜
霸占=霸佔
霁范=霽範
灵药=靈藥
青山一发=青山一髮
青苹=青苹
青苹果=青蘋果
青蝇吊客=青蠅弔客
青霉素=青霉素
青霉=青黴
非占不可=非佔不可
面包住=面包住
面包含=面包含
面包围=面包圍
面包容=面包容
面包庇=面包庇
面包厢=面包廂
面包抄=面包抄
面包括=面包括
面包揽=面包攬
面包涵=面包涵
面包管=面包管
面包扎=面包紮
面包罗=面包羅
面包着=面包著
面包藏=面包藏
面包装=面包裝
面包裹=面包裹
面包起=面包起
面包办=面包辦
面店舖=面店舖
面朝着=面朝著
面条目=面條目
面條目=面條目
面粉碎=面粉碎
面粉红=面粉紅
面临着=面臨著
面食饭=面食飯
面食面=面食麵
鞋里=鞋裡
鞣制=鞣製
秋千=鞦韆
鞭辟入里=鞭辟入裡
韦庄=韋莊
韩国制=韓國製
韩制=韓製
音准=音準
音声如钟=音聲如鐘
韶山冲=韶山沖
响钟=響鐘
頁面=頁面
页面=頁面
頂多=頂多
顶多=頂多
项庄=項莊
顺于=順於
顺钟向=順鐘向
顺风后=順風後
须根据=須根據
颂系=頌繫
颂赞=頌讚
预制=預製
领域里=領域裡
领袖欲=領袖慾
头巾吊在水里=頭巾弔在水裡
头里=頭裡
头发=頭髮
颊须=頰鬚
题签=題籤
额征=額徵
额我略历=額我略曆
额我略历史=額我略歷史
颜范=顏範
颠干倒坤=顛乾倒坤
颠覆=顛覆
颠颠仆仆=顛顛仆仆
顛顛仆仆=顛顛仆仆
颤栗=顫慄
显示表=顯示錶
显示钟=顯示鐘
显示钟表=顯示鐘錶
显著标志=顯著標志
风干=風乾
风后=風后
风土志=風土誌
风后，=風後，
风卷残云=風捲殘雲
风物志=風物誌
风范=風範
风里=風裡
风起云涌=風起雲湧
风采=風采
風采=風采
台风=颱風
台风后=颱風後
刮了=颳了
刮倒=颳倒
刮去=颳去
刮得=颳得
刮走=颳走
刮起=颳起
刮雪=颳雪
刮风=颳風
刮风后=颳風後
飘荡=飄蕩
飘游=飄遊
飘飘荡荡=飄飄蕩蕩
飞扎=飛紮
飞刍挽粟=飛芻輓粟
飞行钟=飛行鐘
食欲=食慾
食欲不振=食欲不振
食野之苹=食野之苹
食面=食麵
饭后钟=飯後鐘
饭团=飯糰
饭庄=飯莊
饲喂=飼餵
饼干=餅乾
馂余=餕餘
余0=餘0
余1=餘1
余2=餘2
余3=餘3
余4=餘4
余5=餘5
余6=餘6
余7=餘7
余8=餘8
余9=餘9
余〇=餘〇
余一=餘一
余七=餘七
余三=餘三
余下=餘下
余九=餘九
余事=餘事
余二=餘二
余五=餘五
余人=餘人
余俗=餘俗
余倍=餘倍
余僇=餘僇
余光=餘光
余八=餘八
余六=餘六
余刃=餘刃
余切=餘切
余利=餘利
余割=餘割
余力=餘力
余勇=餘勇
余十=餘十
余味=餘味
余喘=餘喘
余四=餘四
余地=餘地
余墨=餘墨
余外=餘外
余妙=餘妙
余姚=餘姚
余威=餘威
余子=餘子
余存=餘存
余孽=餘孽
余弦=餘弦
余思=餘思
余悸=餘悸
余庆=餘慶
余数=餘數
余明=餘明
余映=餘映
余暇=餘暇
余晖=餘暉
余杭=餘杭
余杯=餘杯
余桃=餘桃
余桶=餘桶
余业=餘業
余款=餘款
余欢=餘歡
余步=餘步
余殃=餘殃
余毒=餘毒
余气=餘氣
余波=餘波
余波荡漾=餘波盪漾
余温=餘溫
余泽=餘澤
余沥=餘瀝
余烈=餘烈
余热=餘熱
余烬=餘燼
余珍=餘珍
余生=餘生
余众=餘眾
余窍=餘竅
余粮=餘糧
余绪=餘緒
余缺=餘缺
余罪=餘罪
余羡=餘羨
余声=餘聲
余膏=餘膏
余兴=餘興
余蓄=餘蓄
余荫=餘蔭
余裕=餘裕
余角=餘角
余论=餘論
余责=餘責
余貾=餘貾
余辉=餘輝
余辜=餘辜
余酲=餘酲
余量=餘量
余闰=餘閏
余闲=餘閒
余零=餘零
余震=餘震
余霞=餘霞
余音=餘音
余音绕梁=餘音繞梁
余韵=餘韻
余响=餘響
余额=餘額
余风=餘風
余食=餘食
余党=餘黨
余０=餘０
余１=餘１
余２=餘２
余３=餘３
余４=餘４
余５=餘５
余６=餘６
余７=餘７
余８=餘８
余９=餘９
馄饨面=餛飩麵
馆谷=館穀
馆里=館裡
喂乳=餵乳
喂了=餵了
喂奶=餵奶
喂给=餵給
喂羊=餵羊
喂猪=餵豬
喂过=餵過
喂鸡=餵雞
喂食=餵食
喂饱=餵飽
喂养=餵養
喂驴=餵驢
喂鱼=餵魚
喂鸭=餵鴨
喂鹅=餵鵝
饥寒=饑寒
饥民=饑民
饥渴=饑渴
饥溺=饑溺
饥荒=饑荒
饥饱=饑飽
饥馑=饑饉
首当其冲=首當其衝
首发=首發
首只=首隻
香干=香乾
香山庄=香山庄
马干=馬乾
马占山=馬占山
馬占山=馬占山
马杆=馬杆
馬格里布=馬格里布
马格里布=馬格里布
马表=馬錶
驻扎=駐紮
骀荡=駘蕩
腾格里=騰格里
騰格里=騰格里
腾冲=騰衝
惊赞=驚讚
惊钟=驚鐘
骨子里=骨子裡
骨干=骨幹
骨灰坛=骨灰罈
骨坛=骨罈
骨头里挣出来的钱才做得肉=骨頭裡掙出來的錢纔做得肉
肮肮脏脏=骯骯髒髒
肮脏=骯髒
脏乱=髒亂
脏了=髒了
脏兮兮=髒兮兮
脏字=髒字
脏得=髒得
脏心=髒心
脏东西=髒東西
脏水=髒水
脏的=髒的
脏词=髒詞
脏话=髒話
脏钱=髒錢
脏发=髒髮
体范=體範
体系=體系
高几=高几
高干扰=高干擾
高干预=高干預
高干=高幹
高度自制=高度自制
高涌泉=高涌泉
高清愿=高清愿
髡发=髡髮
髭胡=髭鬍
髭须=髭鬚
发上指冠=髮上指冠
发上冲冠=髮上沖冠
发乳=髮乳
发光可鉴=髮光可鑑
发匪=髮匪
发型=髮型
发夹=髮夾
发妻=髮妻
发姐=髮姐
发屋=髮屋
发已霜白=髮已霜白
发带=髮帶
发廊=髮廊
发式=髮式
发引千钧=髮引千鈞
发指=髮指
发卷=髮捲
发根=髮根
发油=髮油
发漂=髮漂
发为血之本=髮為血之本
发状=髮狀
发癣=髮癬
发短心长=髮短心長
发禁=髮禁
发笺=髮箋
发纱=髮紗
发结=髮結
发丝=髮絲
发网=髮網
发脚=髮腳
发肤=髮膚
发胶=髮膠
发菜=髮菜
发蜡=髮蠟
发踊冲冠=髮踊沖冠
发辫=髮辮
发针=髮針
发钗=髮釵
发长=髮長
发际=髮際
发雕=髮雕
发霜=髮霜
发饰=髮飾
发髻=髮髻
发鬓=髮鬢
髯胡=髯鬍
髼松=髼鬆
鬅松=鬅鬆
松一口气=鬆一口氣
松了=鬆了
松些=鬆些
松元音=鬆元音
松劲=鬆勁
松动=鬆動
松口=鬆口
松喉=鬆喉
松土=鬆土
松宽=鬆寬
松弛=鬆弛
松快=鬆快
松懈=鬆懈
松手=鬆手
松掉=鬆掉
松散=鬆散
松柔=鬆柔
松气=鬆氣
松浮=鬆浮
松绑=鬆綁
松紧=鬆緊
松缓=鬆緩
松脆=鬆脆
松脱=鬆脫
松蛋=鬆蛋
松起=鬆起
松软=鬆軟
松通=鬆通
松开=鬆開
松饼=鬆餅
松松=鬆鬆
鬈发=鬈髮
胡子=鬍子
胡梢=鬍梢
胡渣=鬍渣
胡髭=鬍髭
胡髯=鬍髯
胡须=鬍鬚
鬒发=鬒髮
须根=鬚根
须毛=鬚毛
须生=鬚生
须眉=鬚眉
须发=鬚髮
须胡=鬚鬍
须须=鬚鬚
须鲨=鬚鯊
须鲸=鬚鯨
鬓发=鬢髮
斗上=鬥上
斗不过=鬥不過
斗了=鬥了
斗来斗去=鬥來鬥去
斗倒=鬥倒
斗分子=鬥分子
斗力=鬥力
斗劲=鬥勁
斗胜=鬥勝
斗口=鬥口
斗合=鬥合
斗嘴=鬥嘴
斗地主=鬥地主
斗士=鬥士
斗富=鬥富
斗巧=鬥巧
斗幌子=鬥幌子
斗弄=鬥弄
斗引=鬥引
斗别气=鬥彆氣
斗彩=鬥彩
斗心眼=鬥心眼
斗志=鬥志
斗闷=鬥悶
斗成=鬥成
斗打=鬥打
斗批改=鬥批改
斗技=鬥技
斗文=鬥文
斗智=鬥智
斗暴=鬥暴
斗武=鬥武
斗殴=鬥毆
斗气=鬥氣
斗法=鬥法
斗争=鬥爭
斗争斗合=鬥爭鬥合
斗牌=鬥牌
斗牙拌齿=鬥牙拌齒
斗牙斗齿=鬥牙鬥齒
斗牛=鬥牛
斗犀台=鬥犀臺
斗犬=鬥犬
斗狠=鬥狠
斗叠=鬥疊
斗百草=鬥百草
斗眼=鬥眼
斗私批修=鬥私批修
斗而铸兵=鬥而鑄兵
斗而铸锥=鬥而鑄錐
斗脚=鬥腳
斗舰=鬥艦
斗茶=鬥茶
斗草=鬥草
斗叶儿=鬥葉兒
斗叶子=鬥葉子
斗着=鬥著
斗蟋蟀=鬥蟋蟀
斗话=鬥話
斗艳=鬥豔
斗起=鬥起
斗趣=鬥趣
斗闲气=鬥閑氣
斗鸡=鬥雞
斗雪红=鬥雪紅
斗头=鬥頭
斗风=鬥風
斗饤=鬥飣
斗斗=鬥鬥
斗哄=鬥鬨
斗鱼=鬥魚
斗鸭=鬥鴨
斗鹌鹑=鬥鵪鶉
斗丽=鬥麗
闹着玩儿=鬧著玩兒
闹表=鬧錶
闹钟=鬧鐘
哄动=鬨動
哄堂=鬨堂
哄笑=鬨笑
郁伊=鬱伊
郁勃=鬱勃
郁卒=鬱卒
郁南=鬱南
郁堙不偶=鬱堙不偶
郁塞=鬱塞
郁垒=鬱壘
郁律=鬱律
郁悒=鬱悒
郁闷=鬱悶
郁愤=鬱憤
郁抑=鬱抑
郁挹=鬱挹
郁林=鬱林
郁气=鬱氣
郁江=鬱江
郁沉沉=鬱沉沉
郁泱=鬱泱
郁火=鬱火
郁热=鬱熱
郁燠=鬱燠
郁症=鬱症
郁积=鬱積
郁纡=鬱紆
郁结=鬱結
郁蒸=鬱蒸
郁蓊=鬱蓊
郁血=鬱血
郁邑=鬱邑
郁郁=鬱郁
郁金=鬱金
郁闭=鬱閉
郁陶=鬱陶
郁郁不平=鬱鬱不平
郁郁不乐=鬱鬱不樂
郁郁寡欢=鬱鬱寡歡
郁郁而终=鬱鬱而終
郁郁葱葱=鬱鬱蔥蔥
郁黑=鬱黑
鬼谷子=鬼谷子
魂牵梦系=魂牽夢繫
魏征=魏徵
魔杰座=魔杰座
魔表=魔錶
鱼干=魚乾
鱼松=魚鬆
鲸须=鯨鬚
鲇鱼=鯰魚
鸠占鹊巢=鳩佔鵲巢
凤凰于飞=鳳凰于飛
凤梨干=鳳梨乾
鸣钟=鳴鐘
鸿案相庄=鴻案相莊
鸿范=鴻範
鸿篇巨制=鴻篇巨製
鹅准=鵝準
鹄发=鵠髮
雕心雁爪=鵰心雁爪
雕悍=鵰悍
雕翎=鵰翎
雕鹗=鵰鶚
鹤吊=鶴弔
鹤发=鶴髮
鹰雕=鹰鵰
咸味=鹹味
咸嘴淡舌=鹹嘴淡舌
咸土=鹹土
咸度=鹹度
咸得=鹹得
咸批=鹹批
咸水=鹹水
咸派=鹹派
咸海=鹹海
咸淡=鹹淡
咸湖=鹹湖
咸汤=鹹湯
咸潟=鹹潟
咸的=鹹的
咸粥=鹹粥
咸肉=鹹肉
咸菜=鹹菜
咸菜干=鹹菜乾
咸蛋=鹹蛋
咸猪肉=鹹豬肉
咸类=鹹類
咸食=鹹食
咸鱼=鹹魚
咸鸭蛋=鹹鴨蛋
咸卤=鹹鹵
咸咸=鹹鹹
盐打怎么咸=鹽打怎麼鹹
盐卤=鹽滷
盐余=鹽餘
丽于=麗於
曲尘=麴塵
曲蘖=麴櫱
曲生=麴生
曲秀才=麴秀才
曲菌=麴菌
曲车=麴車
曲道士=麴道士
曲钱=麴錢
曲院=麴院
曲霉=麴黴
面人儿=麵人兒
面价=麵價
面包=麵包
面坊=麵坊
面坯儿=麵坯兒
面塑=麵塑
面店=麵店
面厂=麵廠
面摊=麵攤
面杖=麵杖
面条=麵條
面汤=麵湯
面浆=麵漿
面灰=麵灰
面疙瘩=麵疙瘩
面皮=麵皮
面码儿=麵碼兒
面筋=麵筋
面粉=麵粉
面糊=麵糊
面团=麵糰
面线=麵線
面缸=麵缸
面茶=麵茶
面食=麵食
面饺=麵餃
面饼=麵餅
面馆=麵館
麻药=麻藥
麻醉药=麻醉藥
麻酱面=麻醬麵
黄干黑瘦=黃乾黑瘦
黄历=黃曆
黄曲霉=黃曲霉
黄历史=黃歷史
黃詩杰=黃詩杰
黄诗杰=黃詩杰
黄金表=黃金表
黃鈺筑=黃鈺筑
黄钰筑=黃鈺筑
黄钟=黃鐘
黄发=黃髮
黄曲毒素=黃麴毒素
黎吉云=黎吉雲
黎吉雲=黎吉雲
黑奴吁天录=黑奴籲天錄
黑色长发=黑色長髮
黑发=黑髮
点半钟=點半鐘
点多钟=點多鐘
点里=點裡
点钟=點鐘
霉毒=黴毒
霉素=黴素
霉菌=黴菌
霉黑=黴黑
霉黧=黴黧
鼓里=鼓裡
冬冬鼓=鼕鼕鼓
鼠药=鼠藥
鼠曲草=鼠麴草
鼻梁儿=鼻梁兒
鼻梁=鼻樑
鼻准=鼻準
齐王舍牛=齊王捨牛
齐庄=齊莊
齿危发秀=齒危髮秀
齿落发白=齒落髮白
齿发=齒髮
出儿=齣兒
出剧=齣劇
出动画=齣動畫
出卡通=齣卡通
出戏=齣戲
出节目=齣節目
出电影=齣電影
出电视=齣電視
龙卷=龍捲
龙眼干=龍眼乾
龙须=龍鬚
龙斗虎伤=龍鬥虎傷
龟山庄=龜山庄
！克制=！剋制
，克制=，剋制
０周后=０周後
０多只=０多隻
０天后=０天後
０年=０年
０只=０隻
０余=０餘
１周后=１周後
１天后=１天後
１年=１年
１只=１隻
１余=１餘
２周后=２周後
２天后=２天後
２年=２年
２只=２隻
２余=２餘
３周后=３周後
３天后=３天後
３年=３年
３只=３隻
３余=３餘
４周后=４周後
４天后=４天後
４年=４年
４只=４隻
４余=４餘
５周后=５周後
５天后=５天後
５年=５年
５只=５隻
５余=５餘
６周后=６周後
６天后=６天後
６年=６年
６只=６隻
６余=６餘
７周后=７周後
７天后=７天後
７年=７年
７只=７隻
７余=７餘
８周后=８周後
８天后=８天後
８年=８年
８只=８隻
８余=８餘
９周后=９周後
９天后=９天後
９年=９年
９只=９隻
９余=９餘
：克制=：剋制
；克制=；剋制
？克制=？剋制